%s ago=%s în urmă
%s used of %s %s %%=%s folosiți din %s (%s %%)
1 m=1 m
10 s=10 s
2 m=2 m
30 s=30 s
5 m=5 m
Abort background operation=Anulează operațiunea din fundal
Abort background process=Anulează procesul din fundal
Active tunnels=Tunele active
Activity=Activitate
ago=în urmă
Airflow=Flux de aer
Alert Message=Mesaj de alertă
Alerts=Alerte
All Apps=Toate aplicațiile
All VMs=Toate VM-urile
Array Information=Informații Array
Attention - operation continues in background=Atenție - operațiunea continuă în fundal
Battery charge=Nivel baterie
BIOS dated=BIOS cu data
Check free space=Verifică spațiu liber
checking=se verifică
Click to toggle CPU chart=Click pentru a comuta graficul CPU
Click to toggle details=Click pentru a comuta detalii
Clock is synchronized using %s NTP servers, time offset is %s %s=Ceasul este sincronizat folosind %s servere NTP, decalajul este %s %s
Clock is synchronized using %s PTP server, time offset is %s %s=Ceasul este sincronizat folosind serverul PTP %s, decalajul este %s %s
Clock is unsynchronized with no NTP servers=Ceasul este nesincronizat fără servere NTP
Clock is unsynchronized with no PTP servers=Ceasul este nesincronizat fără servere PTP
Clock is unsynchronized, free-running clock=Ceasul este nesincronizat, ceas liber
Clock synchronized with %s NTP server=Ceas sincronizat cu serverul NTP %s
Clock synchronized with %s NTP servers=Ceas sincronizat cu serverul NTP %s
Clone=Clonează
Close Tile=Închide
Completed=Completat
Containers=Containere
Content Management=Gestionare Conținut
Counters info=Informații contoare
Current operation %s on %s=Operațiunea curentă %s pe **%s**
custom image=imagine personalizată
Data is invalid=Datele sunt invalide
default image=imagine implicită
device warning=avertisment dispozitiv
device warnings=avertismente dispozitiv
Docker Containers=Containere Docker
Docker folder=Director Docker
Docker vdisk=vdisk Docker
Due in=Scadent în
Edit VM after clone=Editează VM după clonare
Elapsed time=Timp scurs
emulated=emulat
Errors info=Informații erori
Estimated finish=Finalizare estimată
failed device=dispozitiv eșuat
Fan count=Număr ventilatoare
Fan Information=Informații Ventilatoare
FAN=VENTILATOR
Finding %s error=Găsit: %s eroare
Finding %s errors=Găsit: %s erori
Flash device=Dispozitiv Flash
Free=Liber
FS Native Snapshot=Snapshot Nativ FS
General info=Informații generale
Go to CPU pinning settings=Mergi la setări fixare CPU
Go to date and time settings=Mergi la setări dată și oră
Go to disk settings=Mergi la setări disc
Go to Docker settings=Mergi la setări Docker
Go to fan settings=Mergi la setări ventilator
Go to identification settings=Mergi la setări identificare
Go to network settings=Mergi la setări rețea
Go to scheduler settings=Mergi la setări planificator
Go to Share settings=Mergi la setări Partajare
Go to UPS settings=Mergi la setări UPS
Go to User settings=Mergi la setări Utilizator
Go to VM settings=Mergi la setări VM
Go to VPN settings=Mergi la setări VPN
grandmaster=grandmaster
Handshake=Handshake
has=are
healthy=sănătos
heat warning=avertisment căldură
heat warnings=avertismente căldură
Hide details=Ascunde detalii
in progress=în curs
Inactive tunnels=Tunele inactive
inactive=inactiv
Inbound=Intrare
Information=Informații
Interface Information=Informații Interfață
invalid device=dispozitiv invalid
invalid devices=dispozitive invalide
invalid=invalid
Last check completed on %s=Ultima verificare finalizată pe **%s**
Last check incomplete on %s=Ultima verificare incompletă pe **%s**
Last checked on %s=Ultima verificare pe **%s**
Legend=Legendă
Lock sortable items=Blochează elemente sortabile
Log filesystem=Sistem de fișiere jurnal
master=master
Maximum size=Dimensiune maximă
Memory dump=Descărcare memorie
Memory Utilization=Utilizare Memorie
Mode of operation=Mod de operare
Motherboard Information=Informații Placă de bază
Network traffic=Trafic rețea
New VM=VM Nou
Next check scheduled on %s=Următoarea verificare programată pe **%s**
No docker containers defined=Niciun container docker definit
No running docker containers=Niciun container docker pornit
No running virtual machines=Nicio mașină virtuală pornită
No shares present=Nicio partajare prezentă
No virtual machines defined=Nicio mașină virtuală definită
No VMs running=Niciun VM pornit
Nominal power=Putere nominală
not received=neprimit
Notices=Notificări
Notifications=Notificări
Only PNG images are allowed=Doar imaginile PNG sunt permise!
Outbound=Ieșire
Output voltage=Tensiune ieșire
Overall Load=Încărcare Totală
Overwrite=Suprascrie
Parity disk not present=Discul de paritate nu este prezent
Parity disks not present=Discurile de paritate nu sunt prezente
Parity has not been checked yet=Paritatea nu a fost verificată încă
Parity Information=Informații Paritate
Parity is degraded=Paritatea este degradată
Percent of total used memory=Procent din memoria totală folosită
Percent usage of Docker folder=Procent utilizare dosar Docker
Percent usage of Docker vdisk=Procent utilizare vdisk Docker
Percent usage of flash usb device=Procent utilizare dispozitiv flash usb
Percent usage of LOG file system=Procent utilizare sistem fișiere LOG
Pool=Pool
Popup Blocked=Fereastră pop-up blocată.
Power Status=Stare Alimentare
Power=Putere
Processor Information=Informații Procesor
Put system to sleep=Pune sistemul în repaus
RAM usage=Utilizare RAM
Reboot the system=Repornește sistemul
Receive counters=Contoare primire
Received packets=Pachete primite
Runtime left=Timp rămas de rulare
RX=RX
Scheduled parity check is disabled=Verificarea parității programată este dezactivată
Select Case Model=Alege Model Carcasă
Select time frame=Alege interval de timp
Services=Servicii
Share count %s with %s cache only and %s encrypted=Număr partajări: %s cu %s doar cache și %s criptate
Share count %s with %s public SMB and %s public NFS=Număr partajări: %s cu %s SMB public și %s NFS public
Shares Information=Informații Partajări
Show details=Arată detalii
Show Information=Arată Informații
ShowHide All Content=Arată/Ascunde Tot Conținutul
ShowHide Content=Arată/Ascunde Conținut
Shutdown the system=Oprește sistemul
SMART error=Eroare SMART
SMART errors=Erori SMART
SMART health-check failed=Verificare sănătate SMART eșuată
SMART=SMART
sn=s/n
Snapshot Name=Nume Snapshot
Snapshot=Snapshot
Start Cloned VM=Pornește VM Clonat
Start the array=Pornește array-ul
Started only=Doar pornite
Stop the array=Oprește array-ul
synching=sincronizare
Temp=Temp
This may leave an unknown state=Acest lucru poate lăsa o stare necunoscută
This will put the system to sleep=Aceasta va pune sistemul în repaus
This will reboot the system=Aceasta va reporni sistemul
This will shutdown the system=Aceasta va opri sistemul
This will start the array=Aceasta va porni array-ul
This will stop the array=Aceasta va opri array-ul
Tile Management=Gestionare Tiled
Transmit counters=Contoare transmisie
Transmitted packets=Pachete transmise
TX=TX
Unassigned Devices=Dispozitive Neasignate
Unchecked will use QEMU External Snapshot=Debifat va folosi Snapshot Extern QEMU
Unlock sortable items=Deblochează elemente sortabile
UPS Load=Încărcare UPS
UPS Model=Model UPS
UPS status=Stare UPS
Usable size=Dimensiune utilizabilă
User count %s with %s unprotected=Număr utilizatori: %s cu %s neprotejați
Users Information=Informații Utilizatori
utilization warning=avertisment utilizare
utilization warnings=avertismente utilizare
View Running Processes=Vezi Procese Rulate
Virtual Machines Usage=Utilizare Mașini Virtuale
Virtual Machines=Mașini Virtuale
VM Being Cloned=VM-ul este clonat
VM Clone=Clonare VM
VM Name=Nume VM
VPN Connections=Conexiuni VPN
W=W
Warnings=Avertismente
ZFS=ZFS