3rd Party=Terenți
Access Mode=Mod Acces
Add another Path, Port, Variable, Label or Device=Adaugă Altă Cale, Port, Variabilă, Etichetă sau Dispozitiv
Add Configuration=Adaugă Configurație
Add=Adaugă
Additional Requirements=Cerințe Adiționale
Addresses=Adrese
Always=Întotdeauna
App to Host=Aplicație către Host
Application=Aplicație
apply update=aplică actualizare
Are you sure=Ești sigur
Array must be Started to view Docker containers=Array-ul trebuie să fie **Pornit** pentru a vedea containerele Docker
Autostart=Pornire automată
available=disponibil
Back=Înapoi
Backup=Copie de rezervă
Beta=Beta
Books=Cărți
By=De
Categories=Categorii
Check for Updates=Verifică Actualizări
Cloud=Cloud
Compose=Compose
Config Type=Tip Configurație
Configuration not found=Configurație negăsită
Connection Type=Tip Conexiune
Console shell command=Comandă consolă shell
Container ID=ID Container
Container IP=IP Container
Container not found Try reloading this page to fix=Container negăsit. Încearcă să reîncarci pagina pentru a remedia.
Container not running=Containerul nu rulează
Container Path=Cale Container
Container Port=Port Container
Container Size=Mărime Container
Container=Container
CPU Memory load=Încărcare CPU & Memorie
CPU Pinning=Fixare CPU
Created=Creat
Crypto Currency=Criptomonedă
Default Value=Valoare Implicită
DERP Relay=Releu DERP
Device=Dispozitiv
Display=Afișaj
DNS=DNS
Docker Containers=Containere Docker
Docker Hub URL=URL Docker Hub
Docker Service failed to start=Serviciul Docker nu a reușit să pornească
Downloaders=Descărcătoare
Drivers=Drivere
Edit Configuration=Editează Configurație
Error gathering Tailscale information from container=Eroare la colectarea informațiilor Tailscale din container
Exit Node=Nod Ieșire
Exited=Ieșit
Extra Parameters=Parametri Extra
Expried RenewDisable key expiry=Expirat! Reînnoiește/Dezactivează expirarea cheii!
Fixed IP address=Adresă IP fixă
For security reasons, containers with Network Type Host should not have Tailscale enabled Please disable Tailscale in this container or change the Network Type of the container=Din motive de securitate, containerele cu Tip Rețea "Host" nu ar trebui să aibă Tailscale activat. Te rog dezactivează Tailscale în acest container sau schimbă Tipul Rețelei containerului.
force update=forțează actualizare
FTP=FTP
Game Servers=Servere Jocuri
healthy=sănătos
Hide Buttons=Ascunde Butoane
Hide docker allocations=Ascunde alocări docker
Hide more settings=Ascunde mai multe setări
Home Automation=Automatizare Casă
Host Path=Cale Host
Host Port=Port Host
Hostname=Nume Host
HT=HT
Icon URL=URL Iconiță
Image ID=ID Imagine
Is Exit Node=Este Nod Ieșire
Key Expiry=Expirare Cheie
Key=Cheie
Label=Etichetă
LAN IPPort=IP LAN:Port
Lock sortable items=Blochează elemente sortabile
Management=Gestionare
MediaApp=Aplicație Media
MediaServer=Server Media
Messenger=Mesagerie
Missing parameters=Parametri lipsă
Music=Muzică
Network Type=Tip Rețea
No Docker containers installed=Niciun container Docker instalat
None Listed=Niciunul Listat
of=din
Online=Online
orphan image=imagine orfană
Other=Altele
Overview=Prezentare Generală
Path=Cale
Pause All=Pauză Tot
Photos=Fotografii
Please check the logs and refresh the page=Te rog verifică jurnalele și reîncarcă pagina
Please check the logs=Te rog verifică jurnalele
Port Mappings=Mapări Porturi
Port=Port
Post Arguments=Argumente Post
Privileged=Privilegiat
Productivity=Productivitate
Project Page=Pagina Proiectului
Proxy=Proxy
Pulling image=Se trage imaginea
Read Me First=Citește-mă Întâi
Read Only - Shared=Doar Citire - Partajat
Read Only - Slave=Doar Citire - Sclav
Read Only=Doar Citire
ReadWrite - Shared=Citire/Scriere - Partajat
ReadWrite - Slave=Citire/Scriere - Sclav
Real Hostname=Nume Host Real
rebuild ready=gata de reconstruire
rebuilding=se reconstruiește
Remove template=Elimină șablon
Removing container=Se elimină containerul
Removing orphan image=Se elimină imaginea orfană
Repository=Depozit
Required=Necesar
Reset sorting=Resetează sortarea
Resume All=Reluați Tot
Routes=Rute
Save=Salvează
Select a template=Selectează un șablon
Select categories=Selectează categorii
Show docker allocations=Arată alocări docker
Show more settings=Arată mai multe setări
Stable=Stabil
Start All=Pornește Tot
starting up containers=se pornesc containerele
Stop All=Oprește Tot
Stopping container=Se oprește containerul
Successfully removed container=Container eliminat cu succes
Successfully removed orphan image=Imagine orfană eliminată cu succes
Successfully stopped container=Container oprit cu succes
Support Thread=Fir Suport
Tailscale=Tailscale
Template URL=URL Șablon
Template=Șablon
The command failed=Comanda a eșuat
The command finished successfully=Comanda s-a terminat cu succes
TOTAL DATA PULLED=TOTAL DATE TRASE
Total size=Mărime totală
Unknown action=Acțiune necunoscută
Unlock sortable items=Deblochează elemente sortabile
Update All=Actualizează Tot
update available=actualizare disponibilă
update ready=actualizare gata
URL=URL
Value=Valoare
Variable=Variabilă
Video=Video
Voip=Voip
Volume Mappings=Mapări Volum
wait=așteaptă
Was this container created using this plugin=A fost acest container creat folosind acest plugin
Web=Web
WebUI=WebUI
Writable=Scriibil
; Note: April 21, 2025 - 158 missing translations
