also remove image=și elimină imaginea
Apply=Aplică
Are you sure=Ești sigur?
Cancel=Anulează
checking=se verifică
Completely REMOVE=ELIMINĂ Complet
Console=Consolă
day=zi
days=zile
disk image and definition=imagine disc și definiție
Disks=Discuri
Donate=Donează
Done=Gata
Edit=Editează
Execution error=Eroare execuție
Force Stop=Oprire Forțată
Hibernate=Hibernare
Log for=Jurnal pentru:
log=jurnal
Logs=Jurnale
More Info=Mai multe info
No=Nu
OK=OK
Ok=Ok
Pause=Pauză
Proceed=Continuă
Project Page=Pagina Proiectului
Read Me First=Citește-mă Întâi
Remove container=Elimină container
Remove definition=Elimină definiție
Remove image=Elimină imagine
Remove VM=Elimină VM
Remove=Elimină
Restart=Repornește
Resume=Reia
Start=Pornește
Stop=Oprește
Support=Suport
Update container=Actualizează container
Update=Actualizează
Updating all Containers=Se actualizează toate Containerele
Updating the container=Se actualizează containerul
VNC Remote=VNC Remote
WebUI=WebUI
Yes, delete it=Da, șterge-l!
Yes, update it=Da, actualizează-l!
Yes=Da
; footer messages
Array Copying=Array Se Copiază
Array Clearing=Array Se Șterge
Array Starting=Array Pornește
Array Stopping=Array Se Oprește
Mounting disks=Se montează discurile
Retry unmounting user shares=Reîncearcă demontarea partajărilor utilizator
Spinning up all drives=Se pornesc toate unitățile
Stale configuration=Configurație învechită
Starting services=Se pornesc serviciile
Stopping services=Se opresc serviciile
Starting Recycle Bin=Pornește Coșul de Reciclare
Stopping Recycle Bin=Oprește Coșul de Reciclare
Sync filesystems=Sincronizează sistemele de fișiere
Unmounting disks=Se demontează discurile
Autostart disabled=Pornire automată dezactivată
Missing encryption key=Lipsește cheia de criptare
Opening encrypted volumes=Se deschid volumele criptate
; docker variables
Container Path=Cale Container
Container Port=Port Container
Container Variable=Variabilă Container
Container Label=Etichetă Container
Container Device=Dispozitiv Container
; Note: December 8, 2024 - 65 missing translations
