A format is NEVER part of a data recovery or disk rebuild process and if done in such circumstances will normally lead to loss of all data on the disks being formatted=O formatare nu este **NICIODATĂ** parte a unui proces de recuperare date sau reconstruire disc și dacă este făcută în asemenea circumstanțe va duce, în mod normal, la pierderea tuturor datelor de pe discurile formatate
Aborted=Anulat
Action=Acțiune
Add Pool=Adaugă Pool
Add Subpool=Adaugă Subpool
Add ZFS Subpool=Adaugă Subpool ZFS
Add=Adaugă
After renaming the pool, check that your shares are assigned to the proper primary and secondary storage locations=După redenumirea pool-ului, verifică dacă partajările sunt atribuite locațiilor de stocare primare și secundare corecte
After upgrading the volume may not be mountable in previous versions of Unraid=După actualizare volumul s-ar putea să nu fie montabil în versiunile anterioare de Unraid
All existing data on this device will be OVERWRITTEN when array is Started=Toate datele existente pe acest dispozitiv vor fi **SUPRASCRISE** când array-ul este Pornit
Array Devices=Dispozitive Array
Array of %s devices=Array de %s dispozitive
Array Operation=Operațiune Array
Attribute Name=Nume Atribut
Attributes not available=Atribute indisponibile
Attributes=Atribute
auto=auto
Autotrim=Autotrim
Balance Status=Stare Balanță
Balance=Balanță
Blacklisted=Pe lista neagră
Boot Device=Dispozitiv Boot
Boot system in UEFI mode=Sistem boot în mod UEFI
btrfs balance status=stare balanță btrfs
btrfs check status=stare verificare btrfs
btrfs filesystem usage=utilizare sistem fișiere btrfs
BTRFS operation is running=Operațiune BTRFS în curs
btrfs scrub status=stare scrub btrfs
cache - Cache Devices=cache - Dispozitive Cache
cache - L2ARC=cache - L2ARC
Canceled=Anulat
Cannot contact key-server Please check your=Nu se poate contacta serverul de chei. Te rog verifică
Capabilities not available=Capabilități indisponibile
Capabilities=Capabilități
Caution=**Atenție**
Check Filesystem Status=Verifică Stare Sistem Fișiere
Clear Stats=Șterge Statistici
Clearing in progress=Ștergere în curs
Click on FLASH above this message=Click pe **FLASH** deasupra acestui mesaj
Click to spin down device=Click pentru a opri rotația dispozitivului
Click to spin up device=Click pentru a porni rotația dispozitivului
Comments=Comentarii
complete=complet
Completed without error=Completat fără eroare
completed=completat
Compression=Compresie
Configuration valid=Configurație validă
Convert to raid0 mode=Convertește în mod raid0
Convert to raid1 mode=Convertește în mod raid1
Convert to raid10 mode=Convertește în mod raid10
Convert to raid1c3 mode=Convertește în mod raid1c3
Convert to raid1c4 mode=Convertește în mod raid1c4
Convert to raid5 mode see help=Convertește în mod raid5 *vezi ajutor
Convert to raid6 mode see help=Convertește în mod raid6 *vezi ajutor
Convert to single mode=Convertește în mod single
Copying=Copiere
corrected=corectat
Create an empty file system on the disks shown as Unmountable discarding all data currently on the disks and update parity to reflect this=Creează un sistem de fișiere gol pe discurile afișate ca **Nemontabile** ștergând toate datele curente de pe discuri și actualizează paritatea pentru a reflecta acest lucru
creating Flash backup zip file this may take several minutes=se creează fișier zip backup Flash (acest lucru poate dura câteva minute)
Creating Flash backup=Creare backup Flash
Creation error=Eroare creare
Critical disk temperature threshold=Prag critic temperatură disc
Critical disk utilization threshold=Prag critic utilizare disc
Critical NVME temperature threshold=Prag critic temperatură NVME
Critical SSD temperature threshold=Prag critic temperatură SSD
Current operation %s on %s=Operațiune curentă %s pe **%s**
Current position=Poziție curentă
Custom attributes use comma to separate numbers=Atribute personalizate (folosește virgula pentru a separa numerele)
Data-Rebuild in progress=Reconstruire Date în curs
Date of purchase=Data achiziției
Date=Data
dedup - Deduplication Tables=dedup - Tabele Deduplicare
Delete Pool=Șterge Pool
detected=detectat
Device contents invalid, in standby mode spun-down=Conținut dispozitiv invalid, în mod standby (oprit)
Device contents invalid=Conținut dispozitiv invalid
Device encrypted and unlocked=Dispozitiv criptat și deblocat
Device encrypted=Dispozitiv criptat
Device is disabled=Dispozitivul este dezactivat
Device is missing disabled=Dispozitivul lipsește (dezactivat)
Device is part of a pool=Dispozitivul este parte a unui pool
Device locked unknown error=Dispozitiv blocat: eroare necunoscută
Device locked wrong encryption key=Dispozitiv blocat: cheie criptare greșită
Device to be encrypted=Dispozitiv de criptat
Device=Dispozitiv
Dirty log detected=Jurnal murdar detectat
Disable Spin down delay to run a SMART extended self-test=Dezactivează **Întârziere oprire rotație** pentru a rula un autotest SMART extins
Disk in parity slot is not biggest=Discul în slotul de paritate nu este cel mai mare
Disk Log Information=Informații Jurnal Disc
Disk-Clear in progress=Ștergere-Disc în curs
Do not use reserved names=Nu folosi nume rezervate
Do not use user share names=Nu folosi nume partajări utilizator
Download SMART report=Descarcă raport SMART
Dual parity valid requires ALL disks in their original slots=*Paritate duală* validă necesită **TOATE** discurile în sloturile lor originale
Elapsed time=Timp scurs
Enable user share assignment=Activează atribuire partajare utilizator
encrypted=criptat
Encryption input=Intrare criptare
Encryption status=Stare criptare
enter disk index and device name as applicable to your controller=introdu index disc și nume dispozitiv după cum se aplică controlerului tău
Enter new key=Introdu cheie nouă
Erase Device Content=Șterge Conținut Dispozitiv
Errors occurred - Check SMART report=Au apărut erori - Verifică raport SMART
Estimated finish=Finalizare estimată
Estimated speed=Viteză estimată
Existing content is permanently lost=Conținutul existent este pierdut permanent
Failed=Eșuat
Feature=Caracteristică
File system corruption detected=Corupție sistem de fișiere detectată
File system status=Stare sistem de fișiere
File system type=Tip sistem de fișiere
Finding %s error=Se găsește: **%s** eroare
Finding %s errors=Se găsesc: **%s** erori
Fix=Repară
Flag=Semnalizator
Flash backup=Backup Flash
Flash device is set as public share=Dispozitivul Flash este setat ca partajare publică
Flash Device Settings=Setări Dispozitiv Flash
Format Unmountable disks=Formatează discuri Nemontabile
Formatting=Formatare
formatting=formatare
Free=Liber
FS=FS
Global Configuration=Configurație Globală
Hide=Ascunde
Identification=Identificare
Identity is not available=Identitatea nu este disponibilă
Identity=Identitate
if checked, Start array but do not mount disks=dacă este bifat, Pornește array dar nu monta discurile
If this is a new array, move the largest disk into the parity slot=Dacă acesta este un array nou, mută cel mai mare disc în slotul de *paritate*
If you are adding a new disk or replacing a disabled disk, try Parity-Swap=Dacă adaugi un disc nou sau înlocuiești un disc dezactivat, încearcă Parity-Swap
Incorrect confirmation=Confirmare incorectă
Ineligible to run this version of Unraid OS Please consider extending your=Inelegibil pentru a rula această versiune de Unraid OS. Te rog ia în considerare prelungirea
Insufficient free disk space available=Spațiu liber pe disc insuficient
Information=Informație
Interrupted=Întrerupt
Invalid configuration=Configurație invalidă
invalid device=dispozitiv invalid
invalid devices=dispozitive invalide
Invalid expansion=Expansiune invalidă
Invalid pool name=Nume pool invalid
Invalid, missing or expired=Invalid, lipsă sau expirat
is only available when array is Started in Maintenance mode=este disponibil doar când array-ul este Pornit în mod **Mentenanță**
is only available when array is Started=este disponibil doar când array-ul este Pornit
Keyfile=Fișier cheie
Last check completed on %s=Ultima verificare completată pe **%s**
Last check incomplete on %s=Ultima verificare incompletă pe **%s**
Last checked on %s=Ultima verificare pe **%s**
Last SMART test result=Ultimul rezultat test SMART
logs - Separate Intent Log SLOG=jurnale - Jurnal Intenție Separat (SLOG)
logs - ZFS Intent Log=jurnale - Jurnal Intenție ZFS
loopback=loopback
Maintenance mode=Mod mentenanță
Maintenance Mode=Mod Mentenanță
Maintenance=Mentenanță
Manufacturing date=Data fabricației
Menu View=Vizualizare Meniu
Minimum free space=Spațiu liber minim
mirror=oglindă
Missing Cache disk=Disc Cache lipsă
Missing disk=Disc lipsă
Missing key=Cheie lipsă
Missing pool disk=Disc pool lipsă
Missing=Lipsă
Mounted=Montat
Mover is running=Mover rulează
network settings=setări rețea
New data disks detected=Discuri date noi detectate
next device=următorul dispozitiv
No array data disks have been assigned=Nu au fost atribuite discuri date array
No array devices have been assigned=Nu au fost atribuite dispozitive array
No data disks=Fără discuri date
no devices=fără dispozitive
No devices=Fără dispozitive
No file system corruption detected=Nicio corupție sistem de fișiere detectată
No parity check history present=Istoric verificare paritate inexistent
No self-tests logged on this disk=Niciun autotest înregistrat pe acest disc
Not installed=Neinstalat
Not present=Nu este prezent
not set=nesetat
OK=OK
Once copy completes, the array may be Started, to initiate Data-Rebuild of the disabled disk=Odată ce copierea este gata, array-ul poate fi Pornit, pentru a iniția Reconstruirea Datelor discului dezactivat
operation=operațiune
Options see Help=Opțiuni (vezi Ajutor)
Otherwise use the keyfile method for UTF8 input=Altfel folosește metoda **fișier cheie** pentru intrare UTF8
Parity disks content will be overwritten=Conținutul discurilor de *Paritate* va fi suprascris
Parity is already valid=Paritatea este deja validă
Parity Operation History=Istoric Operațiuni Paritate
Parity operation is running=Operațiune Paritate în curs
Parity valid requires ALL disks to have their original content=*Paritate validă* necesită ca **TOATE** discurile să aibă conținutul original
Parity-Check in progress=Verificare-Paritate în curs
ParityRead-Check History=Istoric Verificare-Paritate/Citire
Parity-Sync in progress=Sincronizare-Paritate în curs
Parity-SyncData-Rebuild in progress=Sincronizare-Paritate/Reconstruire-Date în curs
Partition format=Format partiție
Partition size=Mărime partiție
Passed=Trecut
Passphrase=Frază de acces
Perform full balance=Efectuează balanță completă
Permit UEFI boot mode=Permite mod boot UEFI
Please change share SMB security=Te rog schimbă securitatea partajare SMB
Please check your system settings to support UEFI boot mode=Te rog verifică setările sistemului pentru a suporta mod boot UEFI
Please try again=Te rog încearcă din nou
Pool Devices=Dispozitive Pool
Pool name already exists=Numele pool există deja
Pool of %s devices=Pool de %s dispozitive
Pool Status=Stare Pool
Power=Putere
Preclear in progress=Preclear în curs
previous device=dispozitiv anterior
Printable Characters Only=Doar Caractere Imprimabile
Proceed to start=Continuă pentru a porni
raid0=raid0
raid1=raid1
raid10=raid10
raid1c3=raid1c3
raid1c4=raid1c4
raid5=raid5
raid6=raid6
raidz=raidz
raidz2=raidz2
raidz3=raidz3
Raw Value=Valoare Brută
Raw View=Vizualizare Brută
Read errors corrected=Erori citire corectate
Read errors detected=Erori citire detectate
Read-Check in progress=Verificare-Citire în curs
Reading=Se citește
Reboot in safe mode=Repornește în mod sigur
Registration Key Manager=Manager Chei Înregistrare
registration key=cheie înregistrare
ReiserFS is deprecated, please use another file system=ReiserFS este depreciat, te rog folosește alt sistem de fișiere
reiserfsck status=stare reiserfsck
Rename Pool=Redenumește Pool
Renaming the pool will change the share storage allocations=Redenumirea pool-ului va schimba alocările de stocare partajare
Repair corrupted blocks=Repară blocuri corupte
Replacement disk installed=Disc înlocuitor instalat
Replacement disk is too small=Discul înlocuitor este prea mic
Retype passphrase=Rescrie fraza de acces
Rx=Rx
Schedule=Program
Scrub Status=Stare Scrub
Scrub=Scrub
See %s Settings=Vezi Setări %s
self-test in progress=autotest în curs
Self-Test=Autotest
Server boot mode=Mod boot server
Set default boot menu=Setează meniu boot implicit
show passphrase=arată fraza de acces
Show=Arată
single=single
Slots=Sloturi
SMART attribute notifications=Notificări atribute SMART
SMART controller type=Tip controler SMART
SMART error log=Jurnal erori SMART
SMART extended self-test=Autotest extins SMART
SMART health-check failed=Verificare sănătate SMART eșuată
SMART notification tolerance level=Nivel toleranță notificare SMART
SMART notification value=Valoare notificare SMART
SMART self-test history=Istoric autoteste SMART
SMART self-test in progress=Autotest SMART în curs
SMART Settings=Setări SMART
SMART short self-test=Autotest scurt SMART
SMART status=Stare SMART
spares - Hot Spares=spares - Hot Spares
special - Metadata storage=special - Stocare metadate
special - Special Allocation Class=special - Clasă Alocare Specială
Speed=Viteză
Spin down delay=Întârziere oprire rotație
Spin Down=Oprește Rotație
Spin Up=Pornește Rotație
Spinup groups=Grup(uri) pornire rotație
Started, array protected=Pornit, array protejat
Started, array unprotected=Pornit, array neprotejat
Started, clearing=Pornit, se șterge
Started, formatting=Pornit, se formatează
Starting, copying=Se pornește, se copiază
Starting=Se pornește
Stopping=Se oprește
Sync errors corrected=Erori sincronizare corectate
Sync errors detected=Erori sincronizare detectate
Sync errors=Erori sincronizare
Sync=Sincronizare
Syslinux Configuration=Configurație Syslinux
Syslinux configuration=Configurație Syslinux
Temp=Temp
The array will be immediately available, but unprotected since parity has not been assigned=Array-ul va fi disponibil imediat, dar **neprotejat** deoarece *paritatea* nu a fost atribuită
The array will be immediately available, but unprotected until Parity-Sync completes=Array-ul va fi disponibil imediat, dar **neprotejat** până când Sincronizarea-Parității se finalizează
The replacement disk must be as big or bigger than the original=Discul înlocuitor trebuie să fie la fel de mare sau mai mare decât originalul
The ZFS volume will be upgraded=Volumul ZFS va fi actualizat
This is typically done when a new disk is added to the array to get it ready for files to be written to it=Aceasta se face de obicei când un disc nou este adăugat la array pentru a-l pregăti pentru scrierea fișierelor
This operation cannot be reversed=Această operațiune nu poate fi inversată
This Unraid OS release has been withdrawn and may no longer be used Please=Această versiune Unraid OS a fost retrasă și nu mai poate fi folosită. Te rog
This will ERASE ALL device content=Aceasta va ȘTERGE TOT conținutul dispozitivului
This will ERASE content of ALL devices in the pool=Aceasta va ȘTERGE conținutul TUTUROR dispozitivelor din pool
This will reboot the system=Aceasta va reporni sistemul
This will shutdown the system=Aceasta va opri sistemul
This will stop the array=Aceasta va opri array-ul
This will stop the running operation=Aceasta va opri operațiunea curentă
Threshold=Prag
Title=Titlu
To confirm type %s=Pentru a confirma scrie: %s
Toggle readswrites display=Comută afișaj citiri/scrieri
Too many attached devices Please consider upgrading your=Prea multe dispozitive atașate. Te rog ia în considerare actualizarea
Too many wrong andor missing disks=Prea multe discuri greșite și/sau lipsă
Total size=Mărime totală
Tx=Tx
Unassign ALL devices to delete this pool=De-atribuie **TOATE** dispozitivele pentru a șterge acest pool
Unassigned Devices=Dispozitive Neatribuite
Unavailable - disk must be spun up=Indisponibil - discul trebuie să aibă rotația pornită
unavailable no parity-check entries logged=indisponibil (nicio intrare verificare-paritate în jurnal)
Unavailable=Indisponibil
Unclean shutdown detected=Oprire incorectă detectată
Unmountable disk present=Disc nemontabil prezent
Unmountable disks present=Discuri nemontabile prezente
Unmountable Encrypted volume present=Nemontabil: Volum criptat prezent
Unmountable Missing encryption key=Nemontabil: Cheie criptare lipsă
Unmountable No file system=Nemontabil: Fără sistem de fișiere
Unmountable No pool uuid=Nemontabil: Fără pool uuid
Unmountable not btrfs pool=Nemontabil: nu este pool btrfs
Unmountable Unsupported or no file system=Nemontabil: Nesuportat sau fără sistem de fișiere
Unmountable Volume not encrypted=Nemontabil: Volum necriptat
Unmounted=Nemontat
Upgrade Pool=Actualizează Pool
Upgrading diskswapping parity=Actualizare disc/schimbare paritate
Use ASCII characters from space to tilde=Folosește caractere **ASCII** de la spațiu ' ' la tildă '~'
Use Default=Folosește Implicit
Use default=Folosește implicit
Use only lowercase with no special characters or leadingtrailing digits=Folosește doar litere mici fără caractere speciale sau cifre la început/sfârșit
use printable characters only=folosește doar caractere imprimabile
Used=Folosit
Value=Valoare
W=W
WARNING canceling may leave the array unprotected=AVERTISMENT: anularea poate lăsa array-ul neprotejat
Warning disk temperature threshold=Avertisment prag temperatură disc
Warning disk utilization threshold=Avertisment prag utilizare disc
Warning NVME temperature threshold=Avertisment prag temperatură NVME
Warning SSD temperature threshold=Avertisment prag temperatură SSD
WARNING=AVERTISMENT
Warranty period=Perioadă garanție
While there is some risk, if it is not possible to first mount the filesystem to clear the log, zeroing it is the only option to try and repair the filesystem, and in most cases it results in little or no data loss=Deși există un risc, dacă nu este posibilă montarea sistemului de fișiere pentru a șterge jurnalul, resetarea la zero este singura opțiune pentru a încerca repararea sistemului de fișiere, și în majoritatea cazurilor rezultă în puțină sau nicio pierdere de date
will activate a clean system power down=va activa o oprire *curată* a sistemului
will activate a clean system reset=va activa o resetare *curată* a sistemului
will bring the array on-line and start Clearing new data disks=va aduce array-ul online și va începe **Ștergerea** noilor discuri de date
will bring the array on-line and start Data-Rebuild=va aduce array-ul online și va începe **Reconstruirea-Datelor**
will bring the array on-line and start Disk-Clear of new data disks=va aduce array-ul online și va începe **Ștergerea-Disc** a noilor discuri de date
will bring the array on-line and start Parity-Check=va aduce array-ul online și va începe **Verificarea-Parității**
will bring the array on-line and start Parity-Sync andor Data-Rebuild=va aduce array-ul online și va începe **Sincronizarea-Parității** și/sau **Reconstruirea-Datelor**
will bring the array on-line and start Parity-Sync=va aduce array-ul online și va începe **Sincronizarea-Parității**
will bring the array on-line=va aduce array-ul online
will copy the parity information to the new parity disk=va copia informația de paritate pe noul disc de *paritate*
will create a file system in all Unmountable disks=va crea un sistem de fișiere pe toate discurile **Nemontabile**
will delete the encryption keyfile=va șterge fișierul cheie de criptare
will disable the missing disk and then bring the array on-line Install a replacement disk as soon as possible=va dezactiva discul lipsă și apoi va aduce array-ul online. Instalează un disc înlocuitor cât mai curând posibil
will expand the file system of the data disk if possible then bring the array on-line and start Data-Rebuild=va expanda sistemul de fișiere al discului de date (dacă e posibil); apoi va aduce array-ul online și va începe Reconstruirea-Datelor
will immediately clear all disk statistics=va șterge imediat toate statisticile discurilor
will immediately invoke the Mover=va invoca imediat Mover-ul
will immediately spin down all disks=va opri imediat rotația tuturor discurilor
will immediately spin up all disks=va porni imediat rotația tuturor discurilor
will pause Data-Rebuild=va pune pauză la Reconstruirea-Datelor
will pause Disk-Clear=va pune pauză la Ștergerea-Disc
will pause Parity-Check=va pune pauză la Verificarea-Parității
will pause Parity-Sync=va pune pauză la Sincronizarea-Parității
will pause Read-Check=va pune pauză la Verificarea-Citire
will pause the Clearing=va pune pauză la Ștergere
will pause the Parity-Check=va pune pauză la Verificarea-Parității
will pause the Parity-SyncData-Rebuild=va pune pauză la Sincronizare-Paritate/Reconstruire-Date
will pause the Read-Check=s
will record all disk information and bring the array on-line=va înregistra toate informațiile despre discuri și va aduce array-ul online
will record all disk information, bring the array on-line, and start Parity-Sync=va înregistra toate informațiile despre discuri, va aduce array-ul online, și va începe Sincronizarea-Parității
will remove the missing cache disk and then bring the array on-line=va elimina discul cache lipsă și apoi va aduce array-ul online
will remove the missing pool disk and then bring the array on-line=va elimina discul pool lipsă și apoi va aduce array-ul online
will resume Data-Rebuild=va relua Reconstruirea-Datelor
will resume Disk-Clear=va relua Ștergerea-Disc
will resume Parity-Check=va relua Verificarea-Parității
will resume Parity-Sync=va relua Sincronizarea-Parității
will resume Read-Check=va relua Verificarea-Citire
will resume the paused Clearing=va relua Ștergerea pusă pe pauză
will resume the paused Parity-Check=va relua Verificarea-Parității pusă pe pauză
will resume the paused Parity-SyncData-Rebuild=va relua Sincronizare-Paritate/Reconstruire-Date puse pe pauză
will resume the paused Read-Check=va relua Verificarea-Citire pusă pe pauză
will start Clearing new data disks=va începe **Ștergerea** noilor discuri de date
will start Data-Rebuild=va începe **Reconstruirea-Datelor**
will start Disk-Clear of new data disks=va începe **Ștergerea-Disc** a noilor discuri de date
will start Parity-Check=va începe **Verificarea-Parității**
will start Parity-Sync andor Data-Rebuild=va începe **Sincronizarea-Parității** și/sau **Reconstruirea-Datelor**
will start Parity-Sync=va începe **Sincronizarea-Parității**
will start Read-Check of all array disks=va începe **Verificarea-Citire** a tuturor discurilor din array
will stop Clearing=va opri Ștergerea
will stop Data-Rebuild=va opri Reconstruirea-Datelor
will stop Disk-Clear=va opri Ștergerea-Disc
will stop Parity-Check=va opri Verificarea-Parității
will stop Parity-Sync=va opri Sincronizarea-Parității
will stop Parity-SyncData-Rebuild=va opri Sincronizare-Paritate/Reconstruire-Date
will stop Read-Check=va opri Verificarea-Citire
will stop the Parity-Check=va opri Verificarea-Parității
will stop the Read-Check=va opri Verificarea-Citire
will take the array off-line=va scoate array-ul offline
Worst=Cel mai rău
Write corrections to parity=Scrie corecții în paritate
Writes=Scrieri
Wrong key=Cheie greșită
Wrong Pool State=Stare Pool Greșită
xfs_repair status=stare xfs_repair
You may not add new disks and also remove existing disks=Nu poți adăuga discuri noi și să elimini discuri existente simultan
your server=serverul tău
Zero Log=Zero Log
zfs pool status=stare pool zfs
zfs=zfs
; Sleep plugin translations
Check this=Bifează asta
for more information=pentru mai multe informații
Make sure your server supports S3 sleep=Asigură-te că serverul tău suportă sleep S3
Sleep will immediately put the server in sleep mode=**Sleep** va pune imediat serverul în mod repaus
Sleeping=În repaus
System in sleep mode=Sistem în mod repaus
This will put the system in sleep mode=Aceasta va pune sistemul în mod repaus
wiki entry=articol wiki
; Note: April 21, 2025 - 411 missing translations
