
; Note: April 21, 2025 - 43 missing translations
%s An update is available=%s: O actualizare este disponibilă.
Alert Message=Mesaj de Alertă
anonymous=anonim
Author=Autor
cannot check=nu se poate verifica
Check For Updates=Verifică Actualizări
Checking connectivity=Se verifică conectivitatea
checking=se verifică
Click here to install version %s=Click aici pentru a instala versiunea %s
Delete Plugin=Șterge Plugin
DOWNGRADE TO VERSION=RETROGRADEAZĂ LA VERSIUNEA
Enter URL of remote plugin file or local plugin file=Introdu URL-ul fișierului plugin remote sau fișierului plugin local
ERROR=EROARE
I have read the release notes=Am citit notele de lansare
Install Plugin=Instalează Plugin
Install=Instalează
install=instalează
Installed Plugins=Plugin-uri Instalate
Installing Update=Se Instalează Actualizarea
need check=necesită verificare
Next=Următorul
No plugins installed=Niciun plugin instalat
No release notes available=Nicio notă de lansare disponibilă
No response, aborting=Niciun răspuns, se anulează
Plugin File Install Errors=Erori Instalare Fișier Plugin
Plugin File=Fișier Plugin
Plugin History=Istoric Plugin
Plugin Update Check=Verificare Actualizare Plugin
Plugin=Plugin
Release Notes=Note de Lansare
Remove Plugin=Elimină Plugin
Remove Selected Plugins=Elimină Plugin-urile Selectate
remove=elimină
Select local plugin file=Selectează fișier plugin local
Stable=Stabil
STALE=ÎNVECHIT
Support Thread=Fir Suport
Uninstall=Dezinstalează
Update All Plugins=Actualizează Toate Plugin-urile
Update Incompatible=Actualizare Incompatibilă
Update Plugin=Actualizează Plugin
Upgrade=Actualizare
View Release Notes=Vezi Notele de Lansare
