%s ago=%s în urmă
%s is out of range minimum 1 maximum 65535=%s este în afara intervalului (minim 1 maxim 65535)
; Keep the original plugin name in settings
12 hours=12 ore
24 hours=24 ore
8023ad=802.3ad
a value of zero means no automatic closure=o valoare de zero înseamnă nicio închidere automată
Accumulation duration=Durată acumulare
Accumulation frequency=Frecvență acumulare
Activate=Activează
Activated=Activat
Activating=Se activează
Active Directory Settings=Setări Active Directory
Active Directory=Active Directory
active-backup=active-backup
AD account login=Autentificare cont AD
AD account password=Parolă cont AD
AD domain name=Nume domeniu AD
AD initial group=Grup inițial AD
AD initial owner=Proprietar inițial AD
AD join status=Stare alăturare AD
AD short domain name=Nume scurt domeniu AD
Add network=Adaugă rețea
Add Peer=Adaugă Peer
Add Route=Adaugă Rută
Add Tunnel=Adaugă Tunel
Add VLAN=Adaugă VLAN
Advanced=Avansat
Agent function=Funcție Agent
Agents=Agenți
Alerts=Alerte
Allocation profile=Profil alocare
Allow realtime updates on inactive browsers=Permite actualizări în timp real pe browsere inactive
Allow Remote Access=Permite Acces Remote
Allows the use of ethernet frames larger than 1500 bytes=Permite utilizarea cadrelor ethernet mai mari de 1500 bytes
Allow=Permite
Always On - Manual Port Forward=Mereu Pornit - Port Forward Manual
Always On - UPnP=Mereu Pornit - UPnP
and, the first and last characters must be alphanumeric=și, primele și ultimele caractere trebuie să fie alfanumerice
and=și
Any=Oricare
APC UPS Daemon user manual=Manual utilizator Daemon UPS APC
APCsmart=APCsmart
Apply to activate Docker after Array is Started=Aplică pentru a activa Docker după ce Array-ul este Pornit
Apply to activate VMs after Array is Started=Aplică pentru a activa VM-uri după ce Array-ul este Pornit
Applying=Se aplică
Array must be Stopped to change=Array-ul trebuie să fie **Oprit** pentru a schimba
Array status notification=Notificare stare Array
Array status=Stare Array
Assignment error=Eroare atribuire
Attention=Atenție
Attribute=Atribut
Authentication method=Metodă autentificare
auto=auto
Auto-close=Închidere automată
automatic=automat
Autostart=Pornire automată
Available notifications=Notificări disponibile
bad or missing key file=fișier cheie rău sau lipsă
Balance schedule=Program Balanță
balance-alb=balance-alb
Balanced operation=Operațiune echilibrată
balance-rr=balance-rr
balance-tlb=balance-tlb
balance-xor=balance-xor
Bar color - Text=Bară (culoare) - Text
Bar color=Bară (culoare)
Bar gray - Text=Bară (gri) - Text
Bar gray=Bară (gri)
Basic=Basic
Battery Charge=Nivel Baterie
Battery level to initiate shutdown=Nivel baterie pentru a iniția oprirea
Best performance=Cea mai bună performanță
Best power efficiency=Cea mai bună eficiență energetică
bfq=bfq
Block group usage=Utilizare grup blocuri
Bonding members of=Membri Bonding ai
Bonding mode=Mod Bonding
boost=boost
Both Web Virt-Manager Remote Viewer=Ambele Web & Virt-Manager Remote Viewer
Both=Ambele
bottom-left=stânga-jos
bottom-right=dreapta-jos
Boxed=Încasetat
Bridging members of=Membri Bridging ai
broadcast=broadcast
Browser=Browser
btrfs filesystem show=btrfs filesystem show
btrfs scrub status=stare scrub btrfs
btrfs vDisk=vDisk btrfs
Cache disk not enabled=Disc Cache neactivat
Cache Settings=Setări Cache
Cannot provision cert that would overwrite your existing custom cert at=Nu se poate proviziona cert care ar suprascrie cert-ul tău personalizat existent la
Cannot renew a custom cert at=Nu se poate reînnoi un cert personalizat la
Cannot renew cert until within 30 days of expiry=Nu se poate reînnoi cert decât cu 30 de zile înainte de expirare
CA-signed certificate file=Fișier certificat semnat CA
Caution=Atenție
Celsius=Celsius
center=centru
Certificate expiration=Expirare certificat
Certificate issuer=Emitent certificat
Certificate not valid for=Certificat nevalid pentru
Certificate subject=Subiect certificat
Certificate URL=URL Certificat
Certificate will not renew unless you are signed in to Unraidnet=Certificatul nu se va reînnoi decât dacă ești autentificat în Unraid.net
Change encryption key=Schimbă cheie criptare
Change power mode=Schimbă mod putere
Changes=Schimbări
Changing key failed for disks=Schimbarea cheii a eșuat pentru discurile
Check cable=Verifică cablu
Check four times a day=Verifică de patru ori pe zi
Check once a day=Verifică o dată pe zi
Check once a month=Verifică o dată pe lună
Check once a week=Verifică o dată pe săptămână
Check twice a day=Verifică de două ori pe zi
Checking=Se verifică
CIDR optional=CIDR opțional
Click here to see the Unraid Wiki for more information=Click aici pentru a vedea Wiki Unraid pentru mai multe informații
Click to invoke the Mover=Click pentru a invoca Mover-ul
Click to select PNG file=Click pentru a selecta fișier PNG
Click to Select=Click pentru a Selecta
Comma separated list of IPv4 and IPv6 IP addresses=Listă separată prin virgulă de adrese IP IPv4 și IPv6
configure your router with a static route of=configurează-ți routerul cu o rută statică de
configure your router with port forwarding of port=configurează-ți routerul cu port forwarding pentru portul
configuring interface=se configurează interfața
Confirm array stop command=Confirmă comandă oprire array
Confirm reboot powerdown commands=Confirmă comenzi repornire & oprire
Confirm sleep command=Confirmă comandă repaus
Confirmations=Confirmări
Connect Remote Access=Conectare Acces Remote
connect to any device on the VPN tunnel=conectare la orice dispozitiv pe tunelul VPN
connect to this server using IP address=conectare la acest server folosind adresa IP
Connect to WiFi network=Conectare la rețea WiFi
Connected to Unraid Connect Cloud=Conectat la Unraid Connect Cloud
Connectivity issues may occur when other devices do not support this feature=Probleme de conectivitate pot apărea când alte dispozitive nu suportă această funcție
Console Options=Opțiuni Consolă
Console Settings=Setări Consolă
Container=Container
Content=Conținut
Copy syslog to flash on shutdown=Copiază syslog pe flash la oprire
Correct file system errors=Corectează erori sistem de fișiere
CPU Isolation A reboot is required to apply changes=Izolare CPU: O repornire este necesară pentru a aplica schimbările
CPU isolation is prohibited while system is running in SAFE MODE=Izolarea CPU este interzisă în timp ce sistemul rulează în MOD SIGUR
CPU Isolation=Izolare CPU
CPU Pinning Docker=Fixare CPU Docker
CPU Pinning VM=Fixare CPU VM
CPU Pinning=Fixare CPU
CRAM-MD5=CRAM-MD5
Cumulative parity check=Verificare paritate cumulativă
Current date and time=Data și ora curentă
Current listening interfaces=Interfețe de ascultare curente
Current usage ratio=Raport utilizare curent
Custom attributes use comma to separate numbers=Atribute personalizate (folosește virgula pentru a separa numerele)
Custom banner=Banner personalizat
Custom UPS cable=Cablu UPS personalizat
Custom=Personalizat
custom=personalizat
D comma G dot=[Z] virgulă : [G] punct
D comma G none=[Z] virgulă : [G] niciunul
D comma G space=[Z] virgulă : [G] spațiu
D dot G comma=[Z] punct : [G] virgulă
D dot G none=[Z] punct : [G] niciunul
D dot G space=[Z] punct : [G] spațiu
Daily=Zilnic
Data received=Date primite
Data sent=Date trimise
Date and Time=Dată și Oră
Date format=Format dată
Day of the month=Ziua lunii
Day of the week=Ziua săptămânii
Day, D Month YYYY=Zi, Z Lună AAAA
Day, DD.MM.YYYY=Zi, ZZ.LL.AAAA
Day, DD-MM-YYYY=Zi, ZZ-LL-AAAA
Day, MMDDYYYY=Zi, LL/ZZ/AAAA
Day, Month D, YYYY=Zi, Lună Z, AAAA
Day, YYYY Month D=Zi, AAAA Lună Z
Day, YYYY-MM-DD=Zi, AAAA-LL-ZZ
DD-MM-YYYY=ZZ-LL-AAAA
Deactivate=Dezactivează
Deactivating=Se dezactivează
Default appdata storage location=Locație stocare implicită appdata
Default critical disk temperature threshold=Prag critic implicit temperatură disc
Default critical disk utilization threshold=Prag critic implicit utilizare disc
Default critical SSD temperature threshold=Prag critic implicit temperatură SSD
Default file system for Array disks=Sistem de fișiere implicit pentru discuri Array
Default ISO storage path=Cale stocare implicită ISO
Default network bridge=Bridge rețea implicit
Default network source=Sursă rețea implicită
Default partition format=Format partiție implicit
Default SMART attribute notifications=Notificări atribute SMART implicite
Default SMART controller type=Tip controler SMART implicit
Default SMART notification tolerance level=Nivel toleranță notificare SMART implicit
Default SMART notification value=Valoare notificare SMART implicită
Default spin down delay=Întârziere oprire rotație implicită
Default VM storage path=Cale stocare implicită VM
Default warning disk temperature threshold=Prag avertisment implicit temperatură disc
Default warning disk utilization threshold=Prag avertisment implicit utilizare disc
Default warning SSD temperature threshold=Prag avertisment implicit temperatură SSD
Default Windows VirtIO driver ISO=ISO driver Windows VirtIO implicit
Define a TLS certificate=Definește un certificat TLS
Delete directory=Șterge director
Delete Image File=Șterge Fișier Imagine
Delete Peer=Șterge Peer
Delete tunnel failed=Ștergerea tunelului a eșuat
Delete Tunnel=Șterge Tunel
Delete vDisk file=Șterge fișier vDisk
Delete VLAN=Șterge VLAN
Deny=Refuză
Deselect All=Deselectează Tot
Desired MTU=MTU Dorit
Detailed=Detaliat
Device=Dispozitiv
DHCP pool=Pool DHCP
directory=director
Disable AutostartStart option for VMs=Dezactivează opțiunea Pornire automată/Pornire pentru VM-uri
Disabled until connected to Unraid Connect Cloud=Dezactivat până la conectarea la Unraid Connect Cloud
Disabled until connected to Unraid Connect Cloud - try reloading the page=Dezactivat până la conectarea la Unraid Connect Cloud - încearcă reîncărcarea paginii
Disk Settings=Setări Disc
Display array totals=Afișează totaluri array
Display device name=Afișează nume dispozitiv
Display position=Afișează poziție
Display Settings=Setări Afișaj
Display width=Lățime afișaj
Display world-wide-name in device ID=Afișează world-wide-name în ID dispozitiv
DNS Propagation is PENDING=Propagarea DNS este ÎN AȘTEPTARE
DNS Rebinding Protection is ENABLED=Protecția DNS Rebinding este ACTIVATĂ
DNS servers=Servere DNS
docker containers on custom networks need static routing=containerele docker pe rețele personalizate necesită rutare statică
Docker custom network type=Tip rețea personalizată Docker
Docker data-root=Docker data-root
Docker directory=Director Docker
Docker LOG maximum file size=Dimensiune maximă fișier LOG Docker
Docker LOG number of files=Număr fișiere LOG Docker
Docker LOG rotation=Rotație LOG Docker
Docker only=Doar Docker
Docker PID Limit=Limită PID Docker
Docker service=Serviciu Docker
Docker Stop Timeout=Timp expirare Oprire Docker
Docker storage driver=Driver stocare Docker
Docker update notification=Notificare actualizare Docker
Docker update=Actualizare Docker
Docker vDisk location=Locație vDisk Docker
Docker vDisk size=Dimensiune vDisk Docker
Docker version=Versiune Docker
Docker VMs=Docker + VM-uri
Docker volume info=Info volum Docker
Docker will be available after Array is Started=Docker va fi disponibil după ce Array-ul este Pornit
Docker=Docker
Dont show RDP option=Nu arăta opțiunea RDP
download error=eroare descărcare
Download Windows VirtIO driver ISO=Descarcă ISO driver Windows VirtIO
Downloading=Se descarcă
Downstream=Downstream
Drag-n-drop a PNG file or click the image at the left=Trage-și-lasă un fișier PNG sau click pe imaginea din stânga
Dumb=Dumb
Duplicate metrics=Metrice duplicate
Duplicate port entered=Port duplicat introdus
Dynamix color theme=Temă culoare Dynamix
eg=ex.
Email recipients=Destinatari email
Email subject prefix=Prefix subiect email
Email=Email
enable advanced settings view=activează vizualizare setări avansate
Enable auto start=Activează pornire automată
Enable bonding=Activează bonding
Enable bridging=Activează bridging
Enable container table readmore-js=Activează container table readmore-js
Enable default gateway=Activează gateway implicit
Enable disk shares=Activează partajări disc
Enable Docker=Activează Docker
Enable jumbo frames=Activează jumbo frames
Enable NetBIOS=Activează NetBIOS
Enable NFS=Activează NFS
Enable NVME power monitoring=Activează monitorizare putere NVME
Enable Outgoing Proxy=Activează Proxy de Ieșire
Enable SMB Multi Channel=Activează SMB Multi Channel
Enable SMB=Activează SMB
Enable spinup groups=Activează grupuri pornire rotație
Enable user shares=Activează partajări utilizator
Enable VLANs=Activează VLAN-uri
Enable VMs=Activează VM-uri
Enable WSD=Activează WSD
encrypted=criptat
Encryption Key Update=Actualizare Cheie Criptare
Enhanced macOS interoperability=Interoperabilitate macOS îmbunătățită
ensure the peer network is different from=asigură-te că rețeaua peer este diferită de
ensure the peer networks are different from=asigură-te că rețelele peer sunt diferite de
Ensure the primary network card eth0 has an IP address=Asigură-te că placa de rețea primară eth0 are o adresă IP.
Enter existing passphrase=Introdu fraza de acces existentă
Enter route + gateway + metric=Introdu rută + gateway + metrică
Erase Pool=Șterge Pool
Ether=Ether
Ethernet Port=Port Ethernet
Event=Eveniment
Every 2 hours=La fiecare 2 ore
Every 3 hours=La fiecare 3 ore
Every 4 hours=La fiecare 4 ore
Every 6 hours=La fiecare 6 ore
Every 8 hours=La fiecare 8 ore
Every day=În fiecare zi
Every hour=În fiecare oră
Every month=În fiecare lună
Every week=În fiecare săptămână
exceeds Disk Shutdown=depășește Oprire Disc
Exclude listening interfaces=Exclude interfețe de ascultare
Excluded disks=Discuri excluse
Execution error=Eroare execuție
Existing encryption key=Cheie criptare existentă
Fahrenheit=Fahrenheit
Failed to open=Eșec la deschidere
Failed to stop=Eșec la oprire
Failure to do so may result in your docker image suffering corruption at a later time=Eșecul în a face acest lucru poate duce la coruperea imaginii docker mai târziu
Fast=Rapid
Favorites enabled=Favorite activate
File system corruption fixed=Corupție sistem de fișiere reparată
Finished=Terminat
First day=Prima zi
First week=Prima săptămână
Flash backup=Backup Flash
Font size=Mărime font
Fourth week=A patra săptămână
FTP server=Server FTP
FTP Server=Server FTP
FTP users=Utilizatori FTP
Full Balance recommended=Balanță Completă recomandată
gateway name or address=nume gateway sau adresă
Gateway=Gateway
Generate Key=Generează Cheie
Generate Keypair=Generează Pereche Chei
Global Share Settings=Setări Partajare Globale
Global SMART Settings=Setări SMART Globale
GraphQL API Developer Sandbox=GraphQL API Developer Sandbox
GRUB Configuration=Configurație GRUB
Hardware=Hardware
Header custom background color=Culoare fundal personalizată antet
Header custom meta text color=Culoare text meta personalizată antet
Header custom secondary text color=Culoare text secundar personalizată antet
Header custom text color=Culoare text personalizată antet
Header menu=Meniu antet
Header show description=Arată descriere antet
HHMM=HH:MM
Hibernate VMs=Hibernare VM-uri
Hidden share names are not allowed=Numele partajărilor ascunse nu sunt permise
Hide dot files=Ascunde fișierele "punct"
Hide=Ascunde
Host access to custom networks=Acces gazdă la rețele personalizate
Hostname from DNS reverse lookup=Nume gazdă (din căutare inversă DNS)
Hostname from syslog message=Nume gazdă (din mesaj syslog)
hosts=hosts
Hourly=Orar
HTML color code of 3 or 6 hexadecimal digits=Cod culoare HTML din 3 sau 6 cifre hexazecimale
HTTP port=Port HTTP
httpIPport or httphostport=http://IP:port sau http://host:port
HTTPS port=Port HTTPS
Huge=Enorm
Identification=Identificare
IEEE 8023=IEEE 802.3
if you have trouble logging in, close all other tabs pointing to this server and clear your browsers cache=dacă ai probleme la autentificare, închide toate celelalte tab-uri care indică spre acest server și șterge cache-ul browserului
Import Tunnel=Importă Tunel
Importance=Importanță
In most cases, this should be your public WAN IPv4 instead=În cele mai multe cazuri, acesta ar trebui să fie IPv4-ul tău WAN public
In most cases, this should be your public WAN IPv4=În cele mai multe cazuri, acesta ar trebui să fie IPv4-ul tău WAN public
In most cases, this should be your public WAN IPv6 instead=În cele mai multe cazuri, acesta ar trebui să fie IPv6-ul tău WAN public
In most cases, this should be your public WAN IPv6=În cele mai multe cazuri, acesta ar trebui să fie IPv6-ul tău WAN public
inactive=inactiv
Include listening interfaces=Include interfețe de ascultare
Included disks=Discuri incluse
Incorrect existing key=Cheie existentă incorectă
Input a IPv4 address=Introdu o adresă IPv4
Input a IPv6 address=Introdu o adresă IPv6
Input a MAC address=Introdu o adresă MAC
Input a NTP server name, NTP pool name or IP address=Introdu un nume server NTP, nume pool NTP sau adresă IP
Input the correct date and time manually=Introdu data și ora corectă manual
Interface description=Descriere interfață
Interface Extra=Extra Interfață
Interface link=Link interfață
Interface Rules=Reguli Interfață
Interface speed=Viteză interfață
Interface=Interfață
Invalid data=Date invalide
Invalid email address=Adresă email invalidă
Invalid IPv4 gateway=Gateway IPv4 invalid
Invalid IPv4 range=Interval IPv4 invalid
Invalid IPv4 subnet=Subnet IPv4 invalid
Invalid IPv6 gateway=Gateway IPv6 invalid
Invalid IPv6 range=Interval IPv6 invalid
Invalid IPv6 subnet=Subnet IPv6 invalid
Invalid pool address=Adresă pool invalidă
Invalid subnet size=Mărime subnet invalidă
IP address or FQDN=Adresă IP sau FQDN
IP Address=Adresă IP
IPv4 address A.B.C.D=Adresă IPv4 A.B.C.D
IPv4 address assignment=Atribuire adresă IPv4
IPv4 address=Adresă IPv4
IPv4 custom network on interface=Rețea personalizată IPv4 pe interfață
IPv4 default gateway=Gateway implicit IPv4
IPv4 DNS server assignment=Atribuire server DNS IPv4
IPv4 DNS server=Server DNS IPv4
IPv4 IPv6=IPv4 + IPv6
IPv4 network=Rețea IPv4
IPv4 only=Doar IPv4
IPv4nn or IPv6nn route=Rută IPv4/nn sau IPv6/nn
IPv6 address assignment=Atribuire adresă IPv6
IPv6 address nnnnxxxxyyyy=Adresă IPv6 nnnn:xxxx::yyyy
IPv6 address=Adresă IPv6
IPv6 custom network on interface=Rețea personalizată IPv6 pe interfață
IPv6 default gateway=Gateway implicit IPv6
IPv6 DNS server assignment=Atribuire server DNS IPv6
IPv6 DNS server=Server DNS IPv6
IPv6 network=Rețea IPv6
IPv6 only=Doar IPv6
IPv6 privacy extensions=Extensii confidențialitate IPv6
ipvlan=ipvlan
is a self-signed certificate, ignore the browsers warning and proceed to the GUI=este un certificat auto-semnat, ignoră avertismentul browserului și continuă către GUI
is a self-signed certificate, ignore the browsers warning when using this certificate=este un certificat auto-semnat, ignoră avertismentul browserului când folosești acest certificat
is down=este jos
is not in the=nu este în
is only available when the filesyestem is mounted=este disponibil doar când sistemul de fișiere este montat
Isolated CPUs=CPU-uri izolate
Isolation=Izolare
Join this network=Alătură-te acestei rețele
Join=Alătură-te
Key successfully changed=Cheie schimbată cu succes
Key=Cheie
Keyfile=Fișier cheie
kyber=kyber
LAN hub spoke access=Acces LAN hub & spoke
LAN to LAN access=Acces LAN la LAN
Language update notification=Notificare actualizare limbă
Language update=Actualizare limbă
Language=Limbă
Large=Mare
Last day=Ultima zi
Last handshake=Ultimul handshake
Last week=Ultima săptămână
LE Cert Provisioned successfully=Certificat LE provizionat cu succes
Leave=Pleacă
Libvirt Log=Jurnal Libvirt
Libvirt storage location=Locație stocare Libvirt
Libvirt vdisk size=Mărime vdisk Libvirt
Libvirt version=Versiune Libvirt
Libvirt volume info=Info volum Libvirt
License key required=Cheie licență necesară
List of default gateways contains duplicate metric values=Lista gateway-urilor implicite conține valori metrice duplicate
List of peers=Listă de peers
List of VLANs contains duplicate VLAN numbers=Lista VLAN-urilor conține numere VLAN duplicate
Listing height=Înălțime listare
Loading=Se încarcă
Local access URLs=URL-uri acces local
Local endpoint=Endpoint local
Local gateway uses UPnP=Gateway local folosește UPnP
Local keyboard layout=Layout tastatură locală
Local master=Master local
Local name=Nume local
Local private key=Cheie privată locală
Local public key=Cheie publică locală
Local screen blank time=Timp stingere ecran local
Local server configuration=Configurație server local
Local server uses NAT=Server local folosește NAT
Local syslog folder=Dosar syslog local
Local syslog maximum file size=Mărime maximă fișier syslog local
Local syslog number of files=Număr fișiere syslog local
Local syslog port=Port syslog local
Local syslog rotation=Rotație syslog local
Local syslog server=Server syslog local
Local TLD=TLD local
Local tunnel address IPv6=Adresă tunel local IPv6
Local tunnel address=Adresă tunel local
Local tunnel firewall=Firewall tunel local
Local tunnel network pool IPv6=Pool rețea tunel local IPv6
Local tunnel network pool=Pool rețea tunel local
Lost communication=Comunicare pierdută
Low on battery=Baterie scăzută
MAC address mismatch=Nepotrivire adresă MAC
MAC address=Adresă MAC
macvlan=macvlan
Mail server port=Port server mail
Mail server=Server mail
Make sure you understand what you are doing before enabling=Asigură-te că înțelegi ce faci înainte de a activa
Manage password=Gestionează parolă
Manage=Gestionează
Management Access=Acces Gestionare
Management Interface=Interfață Gestionare
mandatory=obligatoriu
Manual input=Intrare manuală
Manual=Manual
Max Server Protocol Version=Versiune Maximă Protocol Server
Medium=Mediu
member of=membru al
metric value, a lower value is more preferred=valoare metrică, o valoare mai mică este preferată
Metric=Metrică
Mirror syslog to flash=Oglindește syslog pe flash
Misconfiguration can cause problems=Configurarea greșită poate cauza probleme
Missing Network Name=Nume Rețea Lipsă
Missing new key=Cheie nouă lipsă
Missing subnet size=Mărime subnet lipsă
Missing=Lipsă
MM-DD-YYYY=LL-ZZ-AAAA
ModBus=ModBus
Modify with caution unable to validate path until Array is Started=Modifică cu precauție: imposibil de validat calea până când Array-ul este Pornit
Month of the year=Luna anului
Monthly=Lunar
Move now=Mută acum
Mover is running=Mover rulează
Mover logging=Jurnalizare Mover
Mover schedule=Program Mover
Mover Settings=Setări Mover
mq-deadline=mq-deadline
MTU size=Mărime MTU
Multicast=Multicast
Multi-function=Multi-funcție
Must be signed in to Unraidnet to provision cert=Trebuie să fii autentificat în Unraid.net pentru a proviziona cert
My networks=Rețelele mele
name or ip address=nume sau adresă ip
native=native
Net=Net
Network Info=Info Rețea
Network name=Nume rețea
Network protocol=Protocol rețea
Network Services=Servicii Rețea
Network Settings=Setări Rețea
Never check=Nu verifica niciodată
Never send=Nu trimite niciodată
New date and time=Dată și oră nouă
NFS=NFS
NFSv3=NFSv3
NFSv4=NFSv4
No Balance required=Fără Balanță necesară
No battery detected=Nicio baterie detectată
No Cache device present=Niciun dispozitiv Cache prezent
No Cache disk present=Niciun disc Cache prezent
No change to report=Nicio schimbare de raportat
No CPU pinning available. Docker service must be started=Nicio fixare CPU disponibilă. Serviciul Docker trebuie să fie pornit
No CPU pinning available. VM service must be started=Nicio fixare CPU disponibilă. Serviciul VM trebuie să fie pornit
No encrypted disks found=Niciun disc criptat găsit
no name=fără nume
No Parity disk present=Niciun disc Paritate prezent
No Reply=Niciun Răspuns
No suitable interfaces found for PTP=Nicio interfață potrivită găsită pentru PTP
Nominal Power=Putere Nominală
Non-tabbed=Fără tab-uri
Not activated=Neactivat
Not allowed to assign ZERO cores=Nu se permite atribuirea a ZERO nuclee
Not compatible with NetBIOS=Necompatibil cu NetBIOS
not configured=neconfigurat
Not present=Nu este prezent
not received=neprimit
not set=nesetat
Not up-to-date=Neactualizat
not used=nefolosit
Note=Notă
Nothing to do=Nimic de făcut
Notices=Notificări
Notification Agents=Agenți Notificare
Notification entity=Entitate Notificare
Notification Settings=Setări Notificare
Notifications display=Afișare notificări
NTP interval=Interval NTP
NTP server=Server NTP
NTP=NTP
Number format=Format număr
Number of fuse File Descriptors=Număr descriptori fișiere fuse
Number of Threads=Număr Fire
Number scaling=Scalare numere
Obtaining DNSv4 server=Se obține server DNSv4
Obtaining DNSv6 server=Se obține server DNSv6
Obtaining IPv4 address=Se obține adresă IPv4
Obtaining IPv4 gateway=Se obține gateway IPv4
Obtaining IPv6 address=Se obține adresă IPv6
Obtaining IPv6 gateway=Se obține gateway IPv6
obtaining=se obține
On battery=Pe baterie
One or more paths do not exist=Una sau mai multe căi nu există
Online=Online
Only alphanumeric characters=Doar caractere alfanumerice
Only modify if this is a new installation since this can lead to unwanted behaviour=Modifică doar dacă aceasta este o instalare nouă deoarece poate duce la comportament nedorit!
Only PNG images are allowed=Doar imaginile PNG sunt permise
Oops=Ups
optional metric lowest is preferred, 0 is no default gateway=metrică opțională (cea mai mică este preferată, 0 este fără gateway implicit)
optional metric lowest is preferred=metrică opțională (cea mai mică este preferată)
Optional=Opțional
Or if they are improperly configured, use this feature with care=Sau dacă sunt configurate incorect, folosește această funcție cu grijă
or=sau
Other networks=Alte rețele
Otherwise use the keyfile method for UTF8 input=Altfel folosește metoda **fișier cheie** pentru intrare UTF8
Outgoing Proxy Manager=Manager Proxy de Ieșire
Outgoing Proxy=Proxy de Ieșire
Output Voltage=Tensiune Ieșire
overlay2=overlay2
Override UPS Capacity Watts=Suprascrie Capacitate UPS (Wați)
Page view=Vizualizare pagină
Parity Check=Verificare Paritate
Passphrase=Frază de acces
Password=Parolă
Path does not exist=Calea nu există
PCIe ACS override=Suprascriere PCIe ACS
PCnet=PCnet
Peer allowed IPs=IP-uri permise Peer
Peer DNS server=Server DNS Peer
Peer endpoint=Endpoint Peer
Peer name=Nume Peer
Peer preshared key=Cheie pre-partajată Peer
Peer private key=Cheie privată Peer
Peer public key=Cheie publică Peer
Peer tunnel address IPv6=Adresă tunel Peer IPv6
Peer tunnel address=Adresă tunel Peer
Peer type of access=Tip acces Peer
Peer update required=Actualizare Peer necesară
Perform TRIM Operation=Efectuează Operațiune TRIM
Permit exclusive shares=Permite partajări exclusive
Persistent Bash History=Istoric Bash Persistent
Persistent keepalive=Keepalive persistent
Ping=Ping
Placement of Users menu=Plasare meniu Utilizatori
Please consider re-applying all configurations=Te rog ia în considerare re-aplicarea tuturor configurațiilor
Please disable the VM function=Te rog dezactivează funcția VM
Please do this NOW=Te rog fă asta ACUM
Please enter a valid gateway=Te rog introdu un gateway valid
Please enter a valid range=Te rog introdu un interval valid
Please enter a valid sending email address=Te rog introdu o adresă de email de trimitere validă
Please enter a valid subnet=Te rog introdu un subnet valid
Please match the requested format=Te rog respectă formatul cerut
Please note that the flash backup is not encrypted at this time=Te rog notează că backup-ul flash nu este criptat în acest moment.
Please read the Help carefully=Te rog citește Ajutorul cu atenție
Please Reboot system to make new rules active=Te rog **Repornește** sistemul pentru a activa noile reguli
Please Stop array to complete key installation=Te rog Oprește array-ul pentru a completa instalarea cheii
Plugins update notification=Notificare actualizare plugin-uri
Plugins update=Actualizare plugin-uri
Pool address is out of range=Adresa pool este în afara intervalului
pool device stats=statistici dispozitiv pool
Pool Device Status=Stare Dispozitiv Pool
Pool Information=Informații Pool
Pool subnet size is not defined=Mărimea subnet pool nu este definită
Pool subnet size is too large=Mărimea subnet pool este prea mare
Port %s is already in use by other services=Portul %s este deja folosit de alte servicii
Port %s is duplicated=Portul %s este duplicat
Port %s is out of range minimum 1 maximum 65535=Portul %s este în afara intervalului (minim 1 maxim 65535)
Port already in use=Port deja în uz
Port Down=Port Jos
Port out of range=Port în afara intervalului
Port Up=Port Sus
Power Mode=Mod Putere
Preserve user defined networks=Păstrează rețelele definite de utilizator
Preset service=Serviciu prestabilit
Printable Characters Only=Doar Caractere Imprimabile
Priority in header=Prioritate în antet
Protocol=Protocol
Provision=Provizionează
PTP clock=Ceas PTP
PTP interface=Interfață PTP
PTP mode=Mod PTP
PTP profile=Profil PTP
PTP server=Server PTP
PTP transport=Transport PTP
PTP=PTP
QEMU version=Versiune QEMU
Questions See the documentation=Întrebări? Vezi <a href="https://wiki.unraid.net/Connect" target="_blank">documentația</a>.
raidz1=raidz1
readmodifywrite=citire/modificare/scriere
Receive bitrate=Rată biți primire
recommended=recomandat
reconstruct write=reconstruire scriere
redirects to=redirecționează către
Refreshing=Se reîmprospătează
Registration key required=Cheie înregistrare necesară
Regulatory region=Regiune de reglementare
Reinitialize=Reinițializează
Reinitializing=Se reinițializează
Remark configure your router with port forwarding of port=Remarcă: configurează-ți routerul cu port forwarding pentru portul
Remark to use the Dynamic - Manual Port Forward option for Remote Access please set Use SSLTLS to Strict in Management Access=Remarcă: pentru a folosi opțiunea "Dinamic - Port Forward Manual" pentru Acces Remote te rog setează "Folosește SSL/TLS" pe "Strict" în Acces Gestionare.
Remark to use the UPnP options please set Use UPnP to Yes in Management Access=Remarcă: pentru a folosi opțiunile UPnP te rog setează "Folosește UPnP" pe "Da" în Acces Gestionare.
Remark=Remarcă
Remote access to LAN=Acces remote la LAN
Remote access to server=Acces remote la server
Remote peer configuration=Configurație peer remote
Remote syslog port=Port syslog remote
Remote syslog server=Server syslog remote
Remote tunneled access=Acces tunelat remote
Remove pool=Elimină pool
Remove Pool=Elimină Pool
Remove Windows VirtIO driver ISO=Elimină ISO driver Windows VirtIO
Replied=Răspuns
Required=Necesar
resolution=rezoluție
Restore default image=Restaurează imaginea implicită
Retype new passphrase=Rescrie noua frază de acces
Route=Rută
Routing Table=Tabelă Rutare
Rule=Regulă
Rules contain duplicate MAC address assignments=Regulile conțin atribuiri de adrese MAC duplicate
Rules=Reguli
Runtime left to initiate shutdown=Timp rămas pentru a iniția oprirea
Runtime Left=Timp Rămas
Samba extra configuration=Configurație extra Samba
Scheduled parity check=Verificare paritateprogramată
Scheduler=Planificator
Scrub schedule=Program Scrub
Scrub Schedule=Program Scrub
Scrub=Scrub
Second week=A doua săptămână
See Help for more details and workarounds=Vezi Ajutor pentru mai multe detalii și soluții
see interface=vezi interfață
Select All=Selectează Tot
Select existing keyfile=Selectează fișier cheie existent
Select new keyfile=Selectează fișier cheie nou
Select Proxy=Selectează Proxy
Self-signed certificate file=Fișierificat auto-semnat
Self-signed or user-provided certificate=Certificat auto-semnat sau furnizat de utilizator
Send crash information to Unraid developers=Trimite informații despre erori către dezvoltatorii Unraid
Send every hour=Trimite în fiecare oră
Send every two hours=Trimite la fiecare două ore
Send four times a day=Trimite de patru ori pe zi
Send once a day=Trimite o dată pe zi
Send once a month=Trimite o dată pe lună
Send once a week=Trimite o dată pe săptămână
Send three times a day=Trimite de trei ori pe zi
Send twice a day=Trimite de două ori pe zi
Sending email address=Adresă email trimitere
Server hub spoke access=Acces server hub & spoke
Server name=Nume server
Server to server access=Acces server la server
Server was unable to provision SSL certificate=Serverul nu a putut proviziona certificatul SSL
Set password=Setează parolă
Setting disabled in safe mode=Setare dezactivată în **mod sigur**
Settings menu=Meniu Setări
Show array utilization indicator=Arată indicator utilizare array
Show banner background color fade=Arată estompare culoare fundal banner
Show banner=Arată banner
Show Dashboard apps=Arată aplicații Dashboard
show passphrase=arată fraza de acces
Show Peer Config=Arată Config Peer
Show RDP menu option=Arată opțiune meniu RDP
Show RDP option=Arată opțiune RDP
Show VM Usage=Arată Utilizare VM
Show=Arată
Shutdown time-out=Timp expirare Oprire
Shutdown VMs=Oprire VM-uri
shutdown=oprire
Sign In to Unraidnet required=Autentificare în Unraid.net necesară
Signal level=Nivel semnal
Simple=Simplu
slave=slave
Slow=Încet
Small=Mic
Smart=Smart
SMB Extras=Extra SMB
SMB Settings=Setări SMB
SMB=SMB
SMTP Settings=Setări SMTP
SNMP=SNMP
Software=Software
Sorry, an error occurred in processing your SSL certificate=Ne pare rău, a apărut o eroare la procesarea certificatului tău SSL
Sorry, an error occurred updating unraidnet DNS records=Ne pare rău, a apărut o eroare la actualizarea înregistrărilor DNS unraid.net
SSH port=Port SSH
Start APC UPS daemon=Pornește daemon UPS APC
Start page=Pagină de start
Static=Static
Stop %s to make changes, see=Oprește **%s** pentru a face schimbări, vezi
Stop corresponding docker containers=Oprește containerele docker corespunzătoare
Store notifications to flash=Stochează notificări pe flash
stripe=bandă
Subject=Subiect
Subnet=Subnet
subnet=subnet
success=succes
Summarized=Rezumat
Switching the Storage Driver requires to delete and rebuild the Docker directory manually=Schimbarea Driverului de Stocare necesită ștergerea și reconstruirea manuală a directorului Docker!
Syslog Server=Server Syslog
System goes down=Sistemul se oprește
System identifier for logfile name=Identificator sistem pentru nume fișier jurnal
System notifications=Notificări sistem
System Setting=Setare Sistem
System Settings=Setări Sistem
Tabbed=Cu tab-uri
Tailscale Lets Encrypt certificate=Certificat Tailscale Let's Encrypt
Tailscale URLs=URL-uri Tailscale
TCP=TCP
TELNET port=Port TELNET
Temperature unit=Unitate temperatură
Template Authoring Mode=Mod Autor Șabloane
Terminal font size=Mărime font Terminal
Test running=Test în curs
Test=Test
Text - Bar color=Text - Bară (culoare)
Text - Bar gray=Text - Bară (gri)
Text=Text
The Local endpoint does not resolve to an IPv4 address=Endpoint-ul Local nu se rezolvă într-o adresă IPv4
The Local endpoint does not resolve to an IPv6 address=Endpoint-ul Local nu se rezolvă într-o adresă IPv6
The Local endpoint resolves to=Endpoint-ul Local se rezolvă în
The Local tunnel network pool cannot be in=Pool-ul rețea tunel Local nu poate fi în
The Local tunnel network pool IPv6 cannot be in=Pool-ul rețea tunel Local IPv6 nu poate fi în
Third week=A treia săptămână
This is required to create VMs in KVM=Aceasta este necesară pentru a crea VM-uri în KVM
this mode requires a network switch with proper setup and support=acest mod necesită un switch de rețea cu configurare și suport adecvat
this must be the only peer in the tunnel and sole active tunnel when in use=acesta trebuie să fie singurul peer în tunel și singurul tunel activ când este în uz
This removes any connections running over this tunnel=Aceasta elimină orice conexiuni care rulează prin acest tunel
This Unraid Server was unreachable from the outside=Acest Server Unraid a fost inaccesibil din exterior
This will unassign all devices from the pool but will NOT modify any device contents=Aceasta va de-atribui toate dispozitivele din pool dar NU va modifica conținutul niciunui dispozitiv
Time format=Format timp
Time of the day=Timpul zilei
