Add Share=Adaugă Partajare
All files encrypted=Toate fișierele criptate
All files protected=Toate fișierele protejate
All files unprotected=Toate fișierele neprotejate
Allocation method=Metodă alocare
Array must be Started to view Shares=Array-ul trebuie să fie **Pornit** pentru a vedea Partajările
Automatically split any directory as required=Împarte automat orice director după cum este necesar
Automatically split only the top five directory levels as required=Împarte automat doar primele cinci nivele de directoare după cum este necesar
Automatically split only the top four directory levels as required=Împarte automat doar primele patru nivele de directoare după cum este necesar
Automatically split only the top level directory as required=Împarte automat doar directorul de nivel superior după cum este necesar
Automatically split only the top three directory levels as required=Împarte automat doar primele trei nivele de directoare după cum este necesar
Automatically split only the top two directory levels as required=Împarte automat doar primele două nivele de directoare după cum este necesar
Clean Up=Curăță
CLEAN UP=CURĂȚĂ
Comments=Comentarii
Compute All=Calculează Tot
Compute=Calculează
Disk Shares=Partajări Disc
Do not use pool names=Nu folosi nume pool
Do not use reserved names=Nu folosi nume rezervate
Enable Copy-on-write=Activează Copy-on-write
Enter a name for the share=Introdu un nume pentru partajare
Excluded disks=Discuri excluse
Exclusive access=Acces exclusiv
Export=Exportă
Fill-up=Umplere
Free Space will be calculated=Spațiul Liber va fi calculat
Free=Liber
has been deleted=a fost șters
HDD=HDD
High-water=High-water
Included disks=Discuri incluse
Invalid Characters=Caractere Invalide
Invalid share name=Nume partajare invalid
is missing=lipsește
it references storage that does not exist=face referire la stocare care nu există
It references storage that does not exist=Face referire la stocare care nu există
Manual do not automatically split directories=Manual: nu împărți automat directoarele
Minimum free space=Spațiu liber minim
Missing share name=Nume partajare lipsă
Most-free=Cel-mai-liber
Mover action=Acțiune Mover
Mover takes no action=Mover nu ia nicio acțiune
Mover transfers files from array to cache=Mover transferă fișiere din array în cache
Mover transfers files from cache to array=Mover transferă fișiere din cache în array
Mover transfers files from Primary storage to Secondary storage=Mover transferă fișiere din stocarea Primară în stocarea Secundară
Mover transfers files from Secondary storage to Primary storage=Mover transferă fișiere din stocarea Secundară în stocarea Primară
next user share=următoarea partajare utilizator
No unused share configurations present=Nicio configurație de partajare nefolosită prezentă
Not used=Nefolosit
Only=Doar
Prefer=Preferă
previous user share=partajarea utilizator anterioară
Primary storage %s=Stocare primară %s
Primary storage for new files and folders=Stocare primară (pentru fișiere și dosare noi)
Primary storage to Secondary storage=Stocare Primară în stocare Secundară
Read=Citire
Recompute=Recalculează
Remove unused share configurations=Elimină configurațiile de partajare nefolosite
Removed share configurations=Configurații de partajare eliminate
Rule=Regulă
Secondary storage to Primary storage=Stocare Secundară în stocare Primară
Secondary storage=Stocare Secundară
Select cache pool=Selectează pool cache
Set when adding new share only=Setează doar la adăugarea unei partajări noi
Share contains data=Partajarea conține date
Share is empty and is safe to delete=Partajarea este goală și este sigură de șters
Share is empty=Partajarea este goală
Share is outside the list of designated disks=Partajarea este în afara listei de discuri desemnate
Share must be empty to be deleted=Partajarea trebuie să fie goală pentru a fi ștearsă
Share name contains invalid characters for ZFS use=Numele partajării conține caractere invalide pentru utilizarea ZFS
Share Settings=Setări Partajare
Share status=Stare partajare
Size=Mărime
Some or all files unencrypted=Unele sau toate fișierele necriptate
Some or all files unprotected=Unele sau toate fișierele neprotejate
Split level=Nivel împărțire
SSD=SSD
Storage=Stocare
There are no exportable disk shares=Nu există partajări de disc exportabile
There are no exportable user shares=Nu există partajări de utilizator exportabile
There are no mountable array or pool disks - cannot add shares=Nu există discuri array sau pool montabile - nu se pot adăuga partajări
There are no mounted array or pool disks - cannot add shares=Nu există discuri array sau pool montate - nu se pot adăuga partajări
This share is invalid=Această partajare este invalidă
Time Machine volume size limit=Limită mărime volum Time Machine
Unknown cache usage=Utilizare cache necunoscută
Unknown encryption state=Stare criptare necunoscută
Unknown protection status=Stare protecție necunoscută
Use cache pool for new filesdirectories=Folosește pool cache (pentru fișiere/directoare noi)
User Shares=Partajări Utilizator
Warning: Configured Pool=Avertisment: Pool Configurat
Write=Scriere
You cannot use the following within share names=Nu poți folosi următoarele în numele partajărilor
; Note: April 21, 2025 - 91 missing translations
