
20 EHCI=2.0 (EHCI)
30 nec XHCI=3.0 (nec XHCI)
30 qemu XHCI=3.0 (qemu XHCI)
9p Mode=Mod 9p
Advanced tuning options=Opțiuni avansate de reglare
Allocation=Alocare
and if using graphics device passthrough it too needs UEFI=și dacă se folosește trecerea dispozitivului grafic, acesta are de asemenea nevoie de UEFI
Are you sure=Ești sigur
Array must be started to view Virtual Machines=Array-ul trebuie să fie **pornit** pentru a vedea Mașini Virtuale
Autostart=Pornire automată
Back=Înapoi
Base Image=Imagine de Bază
Block Devices=Dispozitive Bloc
Boot Order=Ordine Boot
Boot order=Ordine boot
Bus=Magistrală
Capacity=Capacitate
CD1 ISO Image=Imagine ISO CD1
CD2 ISO Image=Imagine ISO CD2
Change Icon=Schimbă Icoană
Check free space=Verifică spațiu liber
Cleanup=Curățare
Click and Select cdrom image to install operating system=Click și Selectează imaginea cdrom pentru a instala sistemul de operare
Clock Offset=Decalaj Ceas
Clocks Offset=Decalaj Ceasuri
Clocks=Ceasuri
Clone=Clonează
Config Folder=Dosar Config
Configure the same IP address on the ipvtap interface=Configurează aceeași adresă IP pe interfața ipvtap
Configure the VM with a static IP address=Configurează VM-ul cu o adresă IP statică
Copy Paste Domain XML Configuration Here=Copiază &amp; Lipește Configurația XML a Domeniului Aici
CPU Mode=Mod CPU
CPUs=CPU-uri
Create=Creează
CreateModify Template=Creează/Modifică Șablon
Creating=Se creează
DateTime=Dată/Timp
define if migratable=definește dacă este migrabil
define Multifunctiion Support=definește Suport Multifuncție
define OS boot options=definește opțiuni boot OS
define the amount memory=definește cantitatea de memorie
define the maximum amount of memory=definește cantitatea maximă de memorie
define type of cpu presented to this vm=definește tipul de cpu prezentat acestui vm
description of virtual machine=descrierea mașinii virtuale
Description=Descriere
Deselect All=Deselectează Tot
Discard=Renunță
Disk capacity has to be greater than %s=Capacitatea discului trebuie să fie mai mare decât %s
Disk devices=Dispozitive disc
Disk devicesVolume=Dispozitive disc/Volum
Disk IO=IO Disc
Displays and RAM=Afișaj(e) și RAM
Download Folder=Dosar Descărcare
Download, Click and Select virtio drivers image=Descarcă, Click și Selectează imaginea driverelor virtio
Downloading=Se descarcă
Driver=Driver
Edit VM after clone=Editează VM după clonare
eg=ex.
Eject CD Drive=Scoate Unitatea CD
Emulated=Emulat
Enable USB boot=Activează boot USB
Enter name=Introdu nume
Error occured=A apărut o eroare
ETA=Timp estimat
Evdev Device=Dispozitiv Evdev
Export User Template=Exportă Șablon Utilizator
Extracting=Se extrage
File exists=Fișierul există.
File for import=Fișier pentru import
File write failed=Scrierea fișierului a eșuat.
Files being removed=Fișiere în curs de eliminare
Folder to save the LibreELEC image to=Dosar pentru a salva imaginea LibreELEC în
Folder to save the OpenELEC image to=Dosar pentru a salva imaginea OpenELEC în
Form View=Vizualizare Formular
free=liber
FS Native Snapshot=Snapshot Nativ FS
GPU is primary adapter, vbios may be required=GPU este adaptorul primar, vbios poate fi necesar
grab options=opțiuni grab
Grab Toggle=Comutare Grab
Grab=Grab
Graphics Card=Placă Grafică
Graphics ROM BIOS=Graphics ROM BIOS
Graphics ROM Needed=Graphics ROM Necesar
Graphics=Grafică
Guest agent not installed=Guest agent neinstalat
Guest CPU=CPU Oaspete
Guest not running or guest agent not installed=Oaspetele nu rulează sau guest agent neinstalat
Guest not running=Oaspetele nu rulează
Hide inline xml=Ascunde xml inline
Host CPU=CPU Gazdă
Host Passthrough=Trecere Gazdă
Hyperv tweaks for Windows=Ajustări Hyperv pentru Windows
Hyper-V=Hyper-V
i440fx will work for most=i440fx va funcționa pentru majoritatea
Icon=Icoană
If name already exists it will be replaced=Dacă numele există deja va fi înlocuit
Import from file=Importă din fișier
Import=Importă
Initial=Inițial
Insert CD=Introdu CD
Insert=Introdu
Interfaces=Interfețe
Invalid storage path=Cale stocare invalidă
Invalid VM to edit=VM invalid pentru editare
IP Address=Adresă IP
ISO Image=Imagine ISO
ISO storage path doesnt exist, please create the user share or empty folder first=Calea stocare ISO nu există, te rog creează partajarea utilizator (sau dosarul gol) mai întâi
ISO storage path doesnt exist=Calea stocare ISO nu există
ISO storage path was empty=Calea stocare ISO a fost goală
keyboard for VM Console=tastatură pentru Consolă VM
keyboard for VNC=tastatură pentru VNC
Leaving blank will use OS name=Lăsând gol se va folosi numele OS
LibreELEC Version=Versiune LibreELEC
LibreELEC=LibreELEC
Libvirt Service failed to start=Serviciul Libvirt a eșuat la pornire
Location of virtual machine files=Locația fișierelor mașinii virtuale
Lock sortable items=Blochează elemente sortabile
Logical CPUs=CPU-uri Logice
Machine=Mașină
Manual configuration required=Configurare manuală necesară
Manual Configuration Required=Configurare Manuală Necesară
Manual=Manual
Max=Max
MD5 verification failed, your download is incomplete or corrupted=Verificarea MD5 a eșuat, descărcarea ta este incompletă sau coruptă
Memory dump=Dump memorie
Memory inuseCurrentMaximum=Memorie în uz/Curent/Maxim
Migratable=Migrabil
Mode=Mod
mount tag inside vm=etichetă montare în interiorul vm
Multifunction=Multifuncție
My Workstation=Stația Mea de Lucru
Name contains invalid characters or does not start with an alphanumberic for a ZFS storage location=Numele conține caractere invalide sau nu începe cu un alfanumeric pentru o locație de stocare ZFS
Name contains invalid characters or does not start with an alphanumberic for a ZFS storage locationOnly these special characters are valid Underscore _ Hyphen - Colon Period=Numele conține caractere invalide sau nu începe cu un alfanumeric pentru o locație de stocare ZFS<br>Doar aceste caractere speciale sunt valide Sublinier (_) Liniuță (-) Două puncte (:) Punct (.)
name of mount tag inside vm=numele etichetei de montare în interiorul vm
Name of virtual machine=Numele mașinii virtuale
Network Bridge=Bridge Rețea
Network IO=IO Rețea
Network MAC=MAC Rețea
Network Model=Model Rețea
Network Source=Sursă Rețea
New VM=VM Nou
No CD image inserted in to drive=Nicio imagine CD introdusă în unitate
No CD image inserted into drive=Nicio imagine CD introdusă în unitate
No GPU=Niciun GPU
No IP, guest agent not installed=Niciun IP, guest agent neinstalat
No pinning set=Nicio fixare setată
No Virtual Machines installed=Nicio Mașină Virtuală instalată
nogpu=nogpu
None available=Niciunul disponibil
Not enough free space, need at least %s MB=Spațiu liber insuficient, nevoie de cel puțin %s MB
Not running=Nu rulează
Not set=Nesetat
Only one VM can be active at the time=Doar un VM poate fi activ pe moment
Only these special characters are valid Underscore _ Hyphen - Colon Period=Doar aceste caractere speciale sunt valide Subliniere (_) Liniuță (-) Două puncte (:) Punct (.)
OpenELEC Version=Versiune OpenELEC
OpenELEC=OpenELEC
Optional=Opțional
OS Install CDRom Bus=OS Install CDRom Bus
OS Install ISO=OS Install ISO
Other PCI Devices=Alte Dispozitive PCI
Other XML=Alt XML
Override Storage Location=Suprascrie Locație Stocare
Overwrite=Suprascrie
OVMF requires a UEFI-compatable OS=OVMF necesită un OS compatibil UEFI
OVMF TPM=OVMF TPM
OVMF=OVMF
Parent=Părinte
password for VM Console=parolă pentru Consolă VM
password for VNC=parolă pentru VNC
path of Unraid share=calea partajării Unraid
path on Unraid share to save LibreELEC settings=calea pe partajarea Unraid pentru a salva setările LibreELEC
path on Unraid share to save OpenELEC settings=calea pe partajarea Unraid pentru a salva setările OpenELEC
Path to ROM BIOS file=Calea către fișier ROM BIOS
Pinned Cores=Nuclee Fixate
Pivot=Pivot
Please choose a folder the LibreELEC image will download to=Te rog alege un dosar în care imaginea LibreELEC se va descărca
Please choose a folder the OpenELEC image will download to=Te rog alege un dosar în care imaginea OpenELEC se va descărca
Pop-up Blocker is enabled Please add this site to your exception list=Pop-up Blocker este activat! Te rog adaugă acest site la lista ta de excepții
port for virtual console=port pentru consola virtuală
Prefix=Prefix
Present=Prezent
Primary=Primar
protocol for virtual console=protocol pentru consola virtuală
Q35 for a newer machine model with PCIE=Q35 pentru un model de mașină mai nou cu PCIE
QEMU Command Line=Linie Comandă QEMU
QEMU64=QEMU64
random mac, you can supply your own=mac aleatoriu, poți furniza propriul tău mac
re-generate random mac address=re-generează adresă mac aleatorie
Remove all files=Elimină toate fișierele
Remove Images=Elimină Imagini
Remove LibreELEC image=Elimină imagine LibreELEC
Remove Meta=Elimină Meta
Remove OpenELEC image=Elimină imagine OpenELEC
Remove this LibreELEC file=Elimină acest fișier LibreELEC
Remove this OpenELEC file=Elimină acest fișier OpenELEC
Remove User Template=Elimină Șablon Utilizator
Rename disabled, %s snapshots exists=Redenumire dezactivată, %s snapshot-uri există
Render GPU=Render GPU
RenderGPU=RenderGPU
Repeat=Repetă
Requires guest agent installed=Necesită guest agent instalat
Requires guest running=Necesită oaspete rulând
Save File Name=Nume Fișier Salvare
Save Path=Cale Salvare
SeaBIOS will work for most=SeaBIOS va funcționa pentru majoritatea
SeaBIOS=SeaBIOS
Select All=Selectează Tot
Select File=Selectează Fișier
Select ISO image=Selectează imagine ISO
Select ISO=Selectează ISO
Select ISOs for CDROMs=Selectează ISO-uri pentru CDROM-uri
Select the BIOS=Selectează BIOS-ul
Select the LibreELEC version to use=Selectează versiunea LibreELEC de folosit
Select the machine model=Selectează modelul mașinii
Select the OpenELEC version to use=Selectează versiunea OpenELEC de folosit
Select the USB Controller to emulate=Selectează Controller-ul USB de emulat
Select=Selectează
Separate sub-folder and image will be created based on Name=Sub-dosar separat și imagine vor fi create bazat pe Nume
Serial=Serial
Set discard option=Setează opțiune discard
Set SDD flag=Setează steag SDD
Set SSD flag=Setează steag SSD
shares=partajări
Show Inline XML=Arată XML Inline
Snapshot Method=Metodă Snapshot
Snapshot Name=Nume Snapshot
Snapshot=Snapshot
Snapshots being removed=Snapshot-uri în curs de eliminare
Snapshots=Snapshot-uri
Some OSes wont support USB3=Unele OS-uri nu vor suporta USB3
Sound Card=Placă Audio
Specify a ISO storage path first=Specifică o cale stocare ISO mai întâi
SSD=SSD
Start All=Pornește Tot
Start Cloned VM=Pornește VM Clonat
Start VM after creation=Pornește VM după creare
Stop All=Oprește Tot
Template exists=Șablonul există.
Template file write failed=Scrierea fișierului șablon a eșuat
Template Name=Nume Șablon
Tickpolicy=Politica Tick
Timer Source=Sursă Timer
Toggle VM autostart=Comută pornire automată VM
Top Image=Imagine Top
Type Method=Tip (Metodă)
type of storage image=tipul imaginii de stocare
Unchecked will use QEMU External Snapshot=Nebifat va folosi Snapshot Extern QEMU
Unknown action=Acțiune necunoscută
Unknown version=Versiune necunoscută
Unlock sortable items=Deblochează elemente sortabile
Unraid Mount tag=Etichetă Montare Unraid
Unraid Mount Tag=Etichetă Montare Unraid
Unraid Share Mode=Mod Partajare Unraid
Unraid Share=Partajare Unraid
Unraid Source Path=Cale Sursă Unraid
Updating=Se actualizează
USB Controller=Controller USB
USB Devices=Dispozitive USB
vCPUs=vCPU-uri
vDisk Bus=Magistrală vDisk
vDisk Location=Locație vDisk
vDisk Size=Mărime vDisk
vDisk Type=Tip vDisk
vDisks vCDs=vDisk-uri / vCD-uri
vDisks=vDisk-uri
Verifying=Se verifică
video for VM Console=video pentru Consolă VM
video for VNC=video pentru VNC
VirtIO Drivers CDRom Bus=VirtIO Drivers CDRom Bus
VirtIO Drivers ISO=VirtIO Drivers ISO
Virtiofs Mode=Mod Virtiofs
Virtual Machines=Mașini Virtuale
Virtual=Virtual
virtual=virtual
VM Being Cloned=VM În Curs de Clonare
VM Being removed=VM În Curs de Eliminare
VM Clone=Clonă VM
VM Console AutoPort=AutoPort Consolă VM
VM Console enable Copypaste=Activează Copiere/lipire Consolă VM
VM Console Keyboard=Tastatură Consolă VM
VM Console Password=Parolă Consolă VM
VM Console Port=Port Consolă VM
VM Console Protocol=Protocol Consolă VM
VM Console Video Driver=Driver Video Consolă VM
VM Console WS Port=Port WS Consolă VM
VM creation error=Eroare creare VM
VM image deletion error=Eroare ștergere imagine VM
VM Name=Nume VM
VM Usage Statisics=Statistici Utilizare VM
VM Usage Statistics=Statistici Utilizare VM
VNC Keyboard=Tastatură VNC
VNC Password=Parolă VNC
VNC Video Driver=Driver Video VNC
VNC=VNC
Warning removing Snapshots can break the chain=Avertisment eliminarea Snapshot-urilor poate rupe lanțul
Wasnt able to stop the process=Nu s-a putut opri procesul
Web UI to start from menu=Web UI de pornit din meniu
Web UI to start=Web UI de pornit
WebUI=WebUI
Windows 7XP=Windows 7/XP
Windows 82012, newer Linux distros=Windows 8/2012, distribuții Linux mai noi
wsport for virtual console=wsport pentru consola virtuală
XML View=Vizualizare XML
; Note: May 31, 2025 - 289 missing translations
