
:day_night_plug:
> Enter your address information (street, city, country) which is used to calculate the sunrise and sunset times of your location.
>
> A geocoding service is used to convert your address to geographical (latitude and longitude) coordinates.<br>
> You need to register with one of the available services and get a unique API key to make use of their service.
>
> The **day** theme is selected between sunrise and sunset<br>
> The **night** theme is selected between sunset and sunrise
:end

; Note: April 21, 2025 - 21 missing translations
Automatic theming=Tematizare automată
Bing API key=Cheie API Bing
Bing=Bing
City name=Nume oraș
Country name=Nume țară
Day theme=Temă de zi
Geocoding service=Serviciu geocodare
Google API key=Cheie API Google
Google=Google
MapQuest API key=Cheie API MapQuest
MapQuest=MapQuest
Night theme=Temă de noapte
No geographical coordinates found for the given address=Nu s-au găsit coordonate geografice pentru adresa dată
Please adjust=Vă rugăm să ajustați
Postal code=Cod poștal
See=Vezi
Street address=Adresă stradă
this site=acest site
to obtain a Bing API key=pentru a obține o cheie API Bing
to obtain a Google API key=pentru a obține o cheie API Google
to obtain a MapQuest API key=pentru a obține o cheie API MapQuest
