Cancel=Anulează

; My PSAs / banners
Happy New Year=La Mulți Ani
Happy Holidays from Andrew, Tracey, and family=Sărbători Fericite de la Andrew, Tracey și familiei
Please Enjoy Responsibly=Vă Rugăm Să Vă Bucurați Responsabil
Popup Blocked CA requires popups to be enabled under certain circumstances You must white list your server within your browser to allow popups=Popup Blocat CA necesită activarea popup-urilor în anumite circumstanțe Trebuie să puneți serverul în lista albă a browserului pentru a permite popup-uri
Docker Service Not Enabled - Only Plugins Available To Be Installed Or Managed=Serviciul Docker Nu Este Activat - Doar Pluginurile Sunt Disponibile Pentru Instalare Sau Gestionare
Docker system failed to start - Only Plugins Available To Be Installed Or Managed=Sistemul Docker a eșuat la pornire - Doar Pluginurile Sunt Disponibile Pentru Instalare Sau Gestionare
Array not started - Only Plugins Available To Be Installed Or Managed=Array nepornit - Doar Pluginurile Sunt Disponibile Pentru Instalare Sau Gestionare
Community Applications works best when cookies are enabled in your browser Certain features may not be available=Community Applications funcționează cel mai bine când cookie-urile sunt activate în browser Anumite funcții pot să nu fie disponibile
Backup Server Active Some icons may not appear, and plugin installations may be affected=Server Backup Activ Unele iconițe pot să nu apară, și instalările de pluginuri pot fi afectate
Debugging enabled This significantly increases the memory used by your browser=Depanare activată Aceasta crește semnificativ memoria folosită de browserul dvs.
Browser translation detected Display issues may result=Traducere browser detectată Pot rezulta probleme de afișare
Action Centre Enabled=Centru Acțiune Activat

; Sorting Options
Sort By=Sortează După
Name Ascending=Nume Ascendent
Name Descending=Nume Descendent
Downloads=Descărcări
Date Added=Data Adăugării
Number Of Apps=Număr De Aplicații
; Initial disclaimer translations
Disclaimer=Disclaimer
All applications listed here are 3rd party additions to Unraid Neither the authors of Community Applications nor Limetech make any warranty as to the suitability of any application listed here=Toate aplicațiile listate aici sunt adăugiri terțe la Unraid Nici autorii Community Applications nici Limetech nu oferă nicio garanție privind potrivirea oricărei aplicații listate aici
Every attempt is made to ensure that only safe and compatible applications are present=Se face orice încercare pentru a asigura că doar aplicațiile sigure și compatibile sunt prezente
Application Policy=Politică Aplicații
I Understand=Înțeleg
Installations of apps disabled You must accept the warning to be able to install applications=Instalările de aplicații dezactivate Trebuie să acceptați avertismentul pentru a putea instala aplicații
Click here=Click aici
%s Results Per Page=%s Rezultate Pe Pagină
Results Per Page: %s=Rezultate Pe Pagină: %s

; Plugin Disclaimer
Community Applications contains both docker containers and plugin applications Plugins are designed for OS enhancements, and run with full privileges on your system and are clearly identified within CA=Community Applications conține atât containere docker cât și aplicații plugin Pluginurile sunt concepute pentru îmbunătățiri OS, și rulează cu privilegii depline pe sistemul dvs. și sunt clar identificate în CA
Plugin Note=Notă Plugin

; Multi Install
Install Plugin Applications=Instalează Aplicații Plugin
Select all on page=Selectează tot pe pagină
Install Application=Instalează Aplicație
Install Applications=Instalează Aplicații
Update Applications=Actualizează Aplicații
Are you sure you want to update %s applications=Sunteți sigur că doriți să actualizați %s aplicații
Are you sure you want to install %s docker and %s plugin applications=Are you sure you want to install %1$s docker and %2$s plugin application(s)

; Searches
Search=Caută
Click Here To Get More Results From DockerHub=Click Aici Pentru A Obține Mai Multe Rezultate De Pe DockerHub
No Matching Applications Found=Nicio Aplicație Potrivită Găsită

; Repository Related
%s removed as favourite repository=%s eliminat ca depozit favorit
%s set as favourite repository=%s setat ca depozit favorit
Click to remove favourite repository=Click pentru a elimina depozit favorit
Click to set %s as favourite repository=Click pentru a seta %s ca depozit favorit
Search for apps in repository=Caută aplicații în depozit
No description present=Nicio descriere prezentă
Go to the forum page=Mergi la pagina forumului
Go to the webpage=Mergi la pagina web
Go to reddit=Mergi la reddit
Go to facebook=Mergi la facebook
Go to discord=Mergi la discord
Go to forum profile=Mergi la profil forum
Show Profile=Arată Profil
SHOW MORE=ARATĂ MAI MULT
SHOW LESS=ARATĂ MAI PUȚIN
Read more=Citește mai mult
Total Applications=Total Aplicații
Total Known Downloads=Total Descărcări Cunoscute
Total Docker Applications=Total Aplicații Docker
Total Plugin Applications=Total Aplicații Plugin
Total Languages=Total Limbi
Average Downloads Per App=Medie Descărcări Per Aplicație
Web Page=Pagină Web
Forum=Forum
Forum Profile=Profil Forum
Profile=Profil
Facebook=Facebook
Reddit=Reddit
Twitter=Twitter
Discord=Discord
Search Apps=Caută Aplicații
Registry=Registru
Details=Detalii
Added=Adăugat
; Install Plugin title of openbox
Install Plugin=Instalează Plugin
Update Plugin=Actualizează Plugin

Requirements not met=Cerințe neîndeplinite
The requirements for this upgrade have not been met on your system=Cerințele pentru această actualizare nu au fost îndeplinite pe sistemul dvs.
The sidebar for the app click info will list the details=The sidebar for the app (click info) will list the details

BACK=ÎNAPOI

; Remove App from previously installed
Delete Template=Șterge Șablon
Yes, delete it=Da, șterge-l

; Uninstall popup
Uninstall Application=Dezinstalează Aplicație
Yes uninstall it=Da dezinstalează

; Remove Private Application
Remove Private Application=Elimină Aplicație Privată
Yes, remove it=Da, elimin-o

; App Pinning
Click to pin this application=Click pentru a fixa această aplicație
Click to unpin this application=Click pentru a dezfixa această aplicație
Pin App=Fixează Aplicație
Unpin App=Dezfixează Aplicație

; Branch installations
Choose A Branch To Install=Alegeți O Ramură De Instalat

; Multiple application installs
; no apps selected
Install Selected Applications=Instalează Aplicațiile Selectate

Yes, install it=Da, instalează

; Multi-install popup
Yes, install them=Da, instalează-le
Cookies not enabled Plugins must be separately installed from docker applications=Cookie-uri neactivate Pluginurile trebuie instalate separat de aplicațiile docker
Docker applications will be installed utilizing the most recently saved template with no user input on your part=Aplicațiile Docker vor fi instalate utilizând cel mai recent șablon salvat fără intervenția dvs.
Updating Support Links=Se actualizează Link-uri Suport
Downloading docker icons=Se descarcă iconițe docker
Finished Installing If the DONE button did not appear, then you will need to click the red X in the top right corner=Instalare Terminată Dacă butonul GATA nu a apărut, atunci va trebui să dați click pe X-ul roșu din colțul dreapta sus

; error messages
No data was returned It is probable that another browser session has rebooted your server Reloading this browser tab will probably fix this error=Nu au fost returnate date E probabil ca o altă sesiune de browser să fi repornit serverul Reîncărcarea acestui tab de browser va repara probabil această eroare
An error occurred Could not find any %s Apps=A apărut o eroare Nu s-au putut găsi nicio %s Aplicație
Download of appfeed failed=Descărcarea appfeed a eșuat
; the %s here refers to a function being called
Something really went wrong here=Ceva a mers foarte prost aici
Post the ENTIRE contents of this message in the Community Applications Support Thread=Postați ÎNTREGUL conținut al acestui mesaj în Firul de Suport Community Applications
Unknown error happened Please post a screenshot in the support thread of the Statistics screen=A apărut o eroare necunoscută Vă rugăm postați o captură de ecran în firul de suport al ecranului Statistici
Something really wrong happened Reloading the Apps tab will probably fix the problem=Ceva foarte greșit s-a întâmplat Reîncărcarea tabului Aplicații va repara probabil problema
This plugin has a duplicated name from another plugin %s This will impact your ability to install both plugins simultaneously=Acest plugin are un nume duplicat cu alt plugin %s Acest lucru va afecta abilitatea de a instala ambele pluginuri simultan
You have been logged out=Ați fost deconectat
Fatal Flash Drive Error=Eroare Fatală Flash Drive
This usually means your flash drive is corrupted or has dropped offline The rest of the Unraid GUI will also be affected Post a new thread in the Unraid forums if this error continues=Acest lucru înseamnă de obicei că unitatea flash este coruptă sau a căzut offline Restul GUI Unraid va fi de asemenea afectat Postați un nou fir în forumurile Unraid dacă această eroare continuă
Fatal Docker Image Error=Eroare Fatală Imagine Docker
Your docker image or folder is either read-only or completely full Issues will result because of this You should create a new post in the Unraid forums and include your diagnostics=Imaginea sau folderul docker este ori doar-citire ori complet plin Vor rezulta probleme din această cauză Ar trebui să creați o nouă postare în forumurile Unraid și să includeți diagnosticele
This template is set up to use a custom network You may have to adjust the network or IP address etc to match your system=Acest șablon este configurat să folosească o rețea personalizată S-ar putea să trebuiască să ajustați rețeaua sau adresa IP etc pentru a se potrivi cu sistemul dvs.
This template is set up to run as Privileged This is a possible security risk and usually does not need to be enabled Note that some applications require privileged in order to operate correctly=Acest șablon este configurat să ruleze ca Privilegiat Acesta este un posibil risc de securitate și de obicei nu trebuie activat Notă că unele aplicații necesită privilegiat pentru a opera corect
One or more ports used by this application are already in use by another service or app running on your server You will need to adjust the host ports accordingly on the template=Unul sau mai multe porturi folosite de această aplicație sunt deja folosite de alt serviciu sau aplicație care rulează pe serverul dvs. Va trebui să ajustați porturile gazdă corespunzător în șablon
Not Enough Memory=Memorie Insuficientă
Community Applications (and Unraid OS) have a minimum required installed memory of 4G CA cannot run without those mimimums being met=Community Applications (și Unraid OS) au o memorie minimă necesară instalată de 4G CA nu poate rula fără ca acele minime să fie îndeplinite

; CA Sections Keep the length reasonable
Home=Acasă
Installed Apps=Aplicații Instalate
Previous Apps=Aplicații Anterioare
Pinned Apps=Aplicații Fixate
Favourite Repo=Depozit Favorit
Action Centre=Centru Acțiune
Recently Added=Adăugate Recent
Random Apps=Aplicații Aleatorii
Top New Installs=Top Instalări Noi
Top Trending Apps=Top Aplicații în Tendințe
Spotlight Apps=Aplicații în Prim Plan
All Apps=Toate Aplicațiile
Statistics=Statistici
Credits=Credite
Support=Suport
VERSION=VERSIUNE
Change Log=Jurnal Modificări
Debugging=Depanare

; Credits
Development=Dezvoltare
Additional Contributions=Contribuții Adiționale
GUI Layout Design=Design Aspect GUI
Application Feed=Feed Aplicații
Additional Testing=Testare Adițională
Moderation=Moderare
Additional Libraries=Biblioteci Adiționale
Copyright=Copyright
Translation=Traducere

; Statistics page

unknown=necunoscut
Last Change To Application Feed=Ultima Modificare la Feed Aplicații
Docker Applications=Aplicații Docker
Plugin Applications=Aplicații Plugin
Templates=Șabloane
Official Containers=Containere Oficiale
Repositories=Depozite
Private Docker Applications=Aplicații Private Docker
Invalid Templates=Șabloane Invalide
Template Errors=Erori Șablon
Blacklisted Apps=Aplicații Pe Lista Neagră
Incompatible Applications=Aplicații Incompatibile
Deprecated Applications=Aplicații Deprecate
Moderation Entries=Intrări Moderare
Primary Server=Server Primar
Backup Server=Server Backup
Installs not allowed from this page=Instalări nepermise de pe această pagină

; Statistics Popup
No invalid templates found=Niciun șablon invalid găsit
These templates are invalid and the application they are referring to is unknown=Aceste șabloane sunt invalide și aplicația la care se referă este necunoscută
No templates were automatically fixed=Niciun șablon nu a fost reparat automat
All of these errors found have been fixed automatically=Toate aceste erori găsite au fost reparate automat
Note that many of these errors can be avoided by following the directions=Notă că multe dintre aceste erori pot fi evitate urmând instrucțiunile
HERE=AICI
The following plugins have duplicated filenames and are not able to be installed simultaneously=Următoarele pluginuri au nume de fișiere duplicate și nu pot fi instalate simultan
The following docker applications refer to the same docker repository but may have subtle changes in the template to warrant this=Următoarele aplicații docker se referă la același depozit docker dar pot avea modificări subtile în șablon pentru a justifica asta
If any of these entries are incorrect then contact the moderators of CA to discuss=Dacă oricare dintre aceste intrări sunt incorecte atunci contactați moderatorii CA pentru a discuta
Global Repository Comments=Comentarii Globale Depozit
Applied to all applications=(Applied to all applications)
Individual Application Moderation=Moderare Individuală Aplicație

; Misc
Community Applications Changelog=Jurnal Modificări Community Applications

Each month we highlight some of the amazing work from our community=În fiecare lună evidențiem o parte din munca uimitoare a comunității noastre
Check out these newly added applications from our awesome community=Verificați aceste aplicații nou adăugate de la comunitatea noastră minunată
Check out these up and coming apps=Verificați aceste aplicații în ascensiune
These apps have the highest percentage of new installs=Aceste aplicații au cel mai mare procentaj de noi instalări
An assortment of randomly chosen apps=Un asortiment de aplicații alese aleatoriu

; Categories try not to be excessively long This is displayed on the left of CA screen

Backup=Backup
Cloud=Cloud
Crypto Currency=Criptomonede
Downloaders=Programe de descărcare
Drivers=Drivere
Game Servers=Servere Jocuri
Home Automation=Automatizare Casă
Media Applications=Aplicații Media
Books=Cărți
Music=Muzică
Photos=Fotografii
Video=Video
Other=Altele
Media Servers=Servere Media
Network Services=Servicii Rețea
DNS=DNS
FTP=FTP
Management=Gestionare
Messenger=Mesagerie
Proxy=Proxy
VOIP=VOIP
VPN=VPN
Web=Web
Privacy=Confidențialitate
Productivity=Productivitate
Security=Securitate
Spotlight=Prim Plan
Tools Utilities=Unelte / Utilitare
System=Sistem
Themes=Teme
Utilities=Utilitare
Private Apps=Aplicații Private
Uncategorized=Necategorizate

; Categories displayed within a popup or on the card.  Where an entry exists after the "=" it is not translated, but rather how it should look
GameServers=GameServers
HomeAutomation=HomeAutomation
MediaApp=MediaApp
MediaAppBooks=MediaApp:Books
MediaAppMusic=MediaApp:Music
MediaAppPhotos=MediaApp:Photos
MediaAppVideo=MediaApp:Video
MediaAppOther=MediaApp:Other
MediaServer=MediaServer
MediaServerBooks=MediaServer:Books
MediaServerMusic=MediaServer:Music
MediaServerPhotos=MediaServer:Photos
MediaServerVideo=MediaServer:Video
MediaServerOther=MediaServer:Other
Network=Network
NetworkDNS=Network:DNS
NetworkFTP=Network:FTP
NetworkManagement=Network:Management
NetworkProxy=Network:Proxy
NetworkVOIP=Network:VOIP
NetworkVPN=Network:VPN
NetworkPrivacy=Network:Privacy
NetworkWeb=Network:Web
NetworkOther=Network:Other
ToolsSystem=Tools:System
ToolsThemes=Tools:Themes
ToolsUtilities=Tools:Utilities
OtherUncategorized=Other:Uncategorized
and %s more=și %s altele

; App Popup Related
This application template has been blacklisted=Acest șablon de aplicație a fost pus pe lista neagră
This application template has been deprecated=Acest șablon de aplicație a fost deprecat
This application has additional requirements=Această aplicație are cerințe suplimentare
Additional Requirements=Cerințe Suplimentare
Donate To Author=Donează Autorului
Donate To Maintainer=Donează Mentenantului
CLOSE=ÎNCHIDE
Author=Autor
Maintainer=Mentenant
DockerHub=DockerHub
Application Template=Șablon Aplicație
DockerHub Stars=Stele DockerHub
Added to CA=Adăugat la CA
Date Updated=Data Actualizării
Current Version=Versiunea Curentă
Min OS=OS Minim
Max OS=OS Maxim
Total Downloads=Descărcări Totale
Popularity=Popularitate
Licence=Licență
Ranked #%s=Clasat #%s
; as in Trending up or down arrow
Trending %s=Tendință %s
; as in As of some date
As of %s=(Din %s)
Play Video=Redă Video
Play Video %s=Redă Video %s
This application is not compatible with your version of Unraid=Această aplicație nu este compatibilă cu versiunea dvs. de Unraid
Another browser tab or device has updated the displayed templates Some actions are not available=Alt tab de browser sau dispozitiv a actualizat șabloanele afișate Unele acțiuni nu sunt disponibile
WebUI=WebUI
Reinstall=Reinstalează
Reinstall From Previous Apps=Reinstalează Din Aplicații Anterioare
Install=Instalează
Uninstall=Dezinstalează
Project=Proiect
Read Me First=Citește-mă Întâi
Install second instance=Instalează a doua instanță
Install Using The Templates Default Tag=Instalează Folosind Eticheta Implicită a Șablonului
Moderator Comments=Comentarii Moderator:
Note not all authors keep up to date on change logs=Notă nu toți autorii țin la curent jurnalele de modificări
Note not all maintainers keep up to date on change logs=Notă nu toți mentenanții țin la curent jurnalele de modificări
Last Update=Ultima Actualizare
Note All statistics are only gathered every 30 days=Notă Toate statisticile sunt adunate doar la fiecare 30 de zile
;the following if using a space you MUST use nbsp but keep it down to one word if at all possible
Donate=Donează
Currently Installed Version=Versiune Curent Instalată
Install The Update=Instalează Actualizarea
; as in you have the latest version already installed
Latest Version=Ultima Versiune
Multi Language Support=Suport Multi Limbă
Support Forum=Forum Suport
; as in more than 100000
More than %s=Mai mult de %s
Remove from Previous Apps=Elimină din Aplicații Anterioare
Remove=Elimină
See All Apps=Vezi Toate Aplicațiile
Favourite=Favorit
Application Type=Tip Aplicație

; Graphs
Trend Per Month=Tendință Pe Lună
Downloads Per Month=Descărcări Pe Lună

; Multi install script
Installing docker applications %s=Se instalează aplicații docker %s
Starting %s=Se pornește %s
%s failed to start You should install it by itself to fix the errors=%s a eșuat la pornire Ar trebui să-l instalați singur pentru a repara erorile
Setting installed applications to autostart=Se setează aplicațiile instalate să pornească automat
Docker Application Installation finished=Instalare Aplicație Docker terminată

; Application Cards
Actions=Acțiuni
Pending=În Așteptare
This application is a driver plugin=Această aplicație este un driver (plugin)
This is a language pack=Acesta este un pachet de limbă
This application is a docker container=Această aplicație este un container docker
This application is a plugin=Această aplicație este un plugin
This is a spotlight application=Aceasta este o aplicație în prim plan
This is your favourite repository=Acesta este depozitul dvs. favorit
This application is from your favourite repository=Această aplicație este din depozitul dvs. favorit
This application is pinned for later viewing=Această aplicație este fixată pentru vizualizare ulterioară
Private Application=Aplicație Privată
Remove Application From List=Elimină Aplicație Din Listă
Check off to select multiple reinstalls=Bifați pentru a selecta reinstalări multiple
Go to the plugin settings=Mergi la setările pluginului
Click to reinstall the application using default values=Click pentru a reinstala aplicația folosind valorile implicite
Click to edit the application values=Click pentru a edita valorile aplicației
Click to reinstall=Click pentru a reinstala
Click to install=Click pentru a instala
Click to go to the WebUI=Click pentru a merge la WebUI
This application template has been deprecated=Acest șablon de aplicație a fost deprecat
This application template has been blacklisted=Acest șablon de aplicație a fost pus pe lista neagră
Click info to see the notes regarding this application=Click info pentru a vedea notele privind această aplicație
This application has additional requirements=Această aplicație are cerințe suplimentare
BETA=BETA
INSTALLED=INSTALAT
OFFICIAL=OFICIAL
UPDATED=ACTUALIZAT
This is an official container=Acesta este un container oficial
Digitally Signed=Semnat Digital
This container is digitally signed=Acest container este semnat digital
Docker Hub=Docker Hub
NOTE You must visit the dockerHub page to gather the information required to install correctly=NOTĂ Trebuie să vizitați pagina dockerHub pentru a aduna informațiile necesare pentru a instala corect
Show CA templates=Arată șabloane CA
Deprecated=Deprecat
Incompatible=Incompatibil
Blacklisted=Pe Lista Neagră
Template Exists=Șablonul Există
Template already exists in Apps=Șablonul există deja în Aplicații
; eg: LinuxServer Repository
%s Repository=Depozitul %s
; eg: Squid's Repository
%s's Repository=Depozitul lui %s

Info=Info
Attention=Atenție
Repository=Depozit
Why we picked it=De ce am ales-o
Application Spotlight %s=Aplicație în Prim Plan %s
Unraid Staff=Personal Unraid

; Page Navigation
Displaying %s - %s of %s=Se afișează %1$s - %2$s (din %3$s)

Updating Content=Se Actualizează Conținutul
Language=Limbă
Switch to this language=Comută la această limbă
Country Code=Cod Țară
Install Language Pack=Instalează Pachet Limbă
Remove Language Pack=Elimină Pachet Limbă
Update Language Pack=Actualizează Pachet Limbă
Installed Version=Versiune Instalată
A note about translations=O notă despre traduceri
Click here to view the language changelog=Click aici pentru a vedea jurnalul de modificări de limbă
View Missing Translations=Vezi Traduceri Lipsă

; Update Checks
Check For Updates=Verifică Actualizări
Check for updates already running=Verificarea actualizărilor rulează deja
Checking for docker container updates=Se verifică actualizări container docker
Checking for plugin updates=Se verifică actualizări plugin
Checking for language updates=Se verifică actualizări limbă
Checking %s=Se verifică %s

; dockerHub conversions
Determine configuration=Determină configurația
Would you like CA to attempt to determine any applicable paths, ports, and variables for the template This will entail performing a test installation of the container It will be automatically deleted after processing The container will not be started=Doriți ca CA să încerce să determine orice căi, porturi și variabile aplicabile pentru șablon? Acest lucru va implica efectuarea unei instalări de test a containerului. Va fi șters automat după procesare. Containerul nu va fi pornit.
An error occurred - Could not determine configuration=A apărut o eroare - Nu s-a putut determina configurația
; WebGui
Click Install to download and install the Community Applications plugin=Click **Instalează** pentru a descărca și instala pluginul **Community Applications**

